################
#--------------#
#----------$---#
#--------------#
#--------------#
#------------#-#
#--------------#
#------#-------#
#---.----------#
#--------------#
#--------------#
################