################
#--------------#
#--------------#
#---------.----#
#--------------#
#--------------#
#--------------#
#--------------#
#--------------#
#---$----------#
#--------------#
################