################
#--------------#
#------$---#---#
#--------#-----#
#--------------#
#--------------#
#--------------#
##-------------#
#--------------#
#----#---------#
##---------.---#
################