################
#----------#---#
#--------------#
#------------.-#
#--------------#
#----#---------#
#--------------#
#--------------#
#--------------#
#---------$----#
#--------------#
################