################
#------------###
#--------------#
#--------------#
#--------------#
#--#--------.--#
#--------------#
#---#----------#
#-----$--------#
#----#---------#
#--------------#
################