################
#------#------##
#--------------#
#-------------.#
#--------------#
#--------------#
#----#---------#
#----------#---#
#--------------#
#-----------$--#
#--------------#
################