################
#----#---------#
#--------------#
#---$----------#
#--------------#
#--------------#
#----------#---#
#--------------#
#--------.-----#
#------#-------#
#--------------#
################