################
#----------#---#
#--------------#
#-----#--------#
#-------------.#
##----------#--#
#--------------#
#--$-----------#
#--------------#
#--------#-----#
#--------------#
################