################
#--------------#
#--------------#
#----------$---#
#--------------#
#--------------#
#--------------#
#--------------#
#---.----------#
#--------------#
#--------------#
################