################
#--------------#
#--------------#
#--------#-----#
#---$-------.--#
#--------------#
#--------------#
#---------#----#
#--#-----------#
#--------------#
#----------#---#
################