################
#----------#---#
#-------$------#
#-#------------#
#--------------#
#----------#---#
#--------------#
#------------#-#
#-----.--------#
#----#---------#
#--------------#
################