################
#--------------#
#--------------#
##-----#-------#
#------------#-#
##$----------.-#
#--------------#
#----#------#--#
#--------------#
#--------------#
#--------------#
################