################
#--------------#
#--------------#
#--------------#
#--------#-----#
#---------#--$-#
#--------------#
#--------------#
##---------#---#
#-------#----#-#
#-.------------#
################