################
#----------#---#
#--------------#
##--.-----#----#
#--------------#
#----------#---#
#--------------#
#----#---------#
#--------------#
#-#------$-----#
#--------------#
################