################
#---#----------#
#------------$-#
#--------------#
#--------------#
#--------------#
#-------.------#
#--------------#
#--------------#
##-------------#
#--------------#
################