################
#-----#--------#
#----------.---#
#--------------#
#--------------#
#---#--#-------#
#--------------#
#----$---------#
#--------------#
##---#---------#
#--------------#
################