################
#--------------#
##--$----------#
#--------------#
#--------------#
#----------#---#
#--#-----------#
#----------#-.-#
#--------------#
#--------------#
#------#-------#
################