################
#-------#------#
#--#-----------#
#--------------#
#--------------#
#--------------#
#--------------#
#-----------.--#
#--------------#
#--#--$--------#
#--------------#
################