################
#---#---#------#
#--$-----------#
#--#-----------#
#------------#-#
#---#----------#
#--------------#
#--------------#
#--------.-----#
#------------#-#
#--------------#
################