################
#-------------##
#--------------#
#------.-------#
#--------------#
#----#---------#
#--------------#
#--------------#
#--------------#
#-$----------#-#
#--------------#
################