################
#--------------#
#-----------$--#
#--------------#
#--------------#
#--------------#
#--------------#
#--------------#
#----.---------#
#--------------#
#--------------#
################