################
#--------------#
#--------------#
#--------------#
#--------------#
#----------.---#
#--------------#
#--------------#
#--------------#
#--$-----------#
#--------------#
################