################
#--#---------#-#
#----#---$-----#
#--#-----------#
#--------------#
#--------------#
#----#---------#
#---#----------#
#--------------#
#-#------------#
#-.------------#
################