################
#---#------.---#
#--------------#
#--#-----------#
#--------------#
#-----------#--#
#--------------#
#--#---#---#---#
#--------------#
#---$----------#
#--------------#
################