################
#--------------#
#-----.--------#
##-#-----------#
#--------------#
#--------------#
#------------#-#
#---#----------#
#----#----$----#
#-----------##-#
#--------------#
################