################
#------.--#----#
#------#-------#
#--------------#
#--------------#
#--------------#
#--------------#
#--------------#
#--------------#
#---------$----#
#--------------#
################