################
#--------.--#--#
#--------------#
#--------------#
#--------------#
#------#-------#
#--------------#
#--------------#
#-$------------#
#--------------#
#--------------#
################