################
#-----------.--#
#--------------#
#-------#-----##
#--------------#
#--------------#
#--------------#
#--------------#
##--$----------#
#--------------#
#--------------#
################