################
##-------------#
##-------------#
#--------------#
#----.-----#---#
#----#----#----#
#--------------#
#--------------#
#--------------#
#-$-#----------#
#--------------#
################