################
#--------------#
#--------------#
#--------------#
#--$-----------#
#------#-------#
#--------------#
#---#----------#
#--------#.----#
#--#-----------#
#--------------#
################