################
#-#--------#---#
#-$------------#
#--------------#
#--------------#
#--#--##-------#
#--------------#
#--------------#
#--#-----------#
#------------.-#
#--------------#
################