################
#--------#-----#
#----#---------#
#------------#-#
#----------.---#
#--$-------#---#
#------------#-#
#--------------#
#--------------#
#------------#-#
#--------------#
################