################
#--------------#
#-------------.#
#----#-----#---#
#------$-------#
#----#---------#
#--------------#
#--------------#
#--------------#
#---#-------#--#
#--------------#
################