################
#--.-----------#
#--------------#
#--------------#
#--#-----------#
#------#---#-#-#
#--------------#
#--------------#
#----#---------#
#---$----------#
#--------------#
################