################
#------#-----#-#
#--------$-----#
#--------------#
#--------------#
#--------------#
#--------------#
#--------------#
#------#-----#-#
#--.-----------#
#------#-------#
################