################
#---#----------#
#---$----------#
#-----##-------#
#--------------#
#--------------#
#--------------#
#---------#----#
#--------------#
##-----------#-#
#------------.-#
################