################
#------.-------#
#--------#-----#
#--------------#
#--------------#
#--------------#
#--------------#
#--------#---#-#
#-$------------#
#--------------#
##-------------#
################