################
#----------#---#
#-------$------#
#--------------#
#--------------#
#--------------#
#--------------#
#--------------#
#--------------#
#------#-------#
#----------.---#
################