################
#------#-------#
#--------------#
#--------------#
#-----------$--#
#--------------#
#--------------#
#--------------#
##-------------#
#--------------#
#--------.-----#
################