################
#--------------#
#------#-$-----#
#--------------#
#--------------#
#--------------#
#--------------#
#--#-----#-----#
#---.----------#
#-#------------#
#----------#---#
################