################
#-----#-------##
#-------$------#
##----##-------#
#--------------#
#--------------#
#--------------#
#----------#-#-#
#--------------#
#-----.--------#
#--------------#
################