################
#--------------#
#--------------#
#-$------------#
#--------------#
#--------------#
#------------#-#
#------.-------#
#--#-----------#
#--------------#
#--------------#
################