################
#--------------#
#--------------#
#---.----------#
#--------------#
#------------#-#
#--------------#
#---------$----#
#--------------#
#--------------#
#----#---------#
################