################
#--------------#
#--------------#
#--------------#
#------------$-#
#--------------#
#--------------#
#--------------#
#----.---------#
#--------------#
#--------------#
################