################
#--------------#
##.------------#
#---##---------#
#--------------#
#--------------#
#--------------#
#--------------#
#--------------#
#---------$----#
#--------------#
################