################
#---.----------#
#--------------#
#--------------#
#--------------#
#--------------#
#--------------#
#----------#---#
#--------------#
#-----$----#---#
#--------------#
################