################
##-----------#-#
#--------------#
#----#---$-----#
#--------------#
#------#-------#
#--------------#
##-------------#
#--------------#
#--------------#
#------#----.--#
################