################
#-----#--------#
#--------------#
#--#-----#-#---#
#--------------#
#--#---#-------#
#-$------------#
#--------------#
#--------------#
#--------------#
#----------.---#
################