################
#---#-------#--#
#-.------------#
#--------------#
#--------------#
#--------------#
#--------------#
#--------------#
#------------$-#
#--------------#
#--------------#
################