################
#------#-------#
##-------------#
#-----#----.---#
#--------------#
#----#---------#
#--------------#
#-$------------#
#--------------#
#--------------#
#--------------#
################