################
#--------------#
#----.---------#
#--------------#
##-------------#
#--------------#
#--------------#
#--------------#
#--------------#
#--##-------$--#
#--------------#
################