################
##-------------#
#-$------------#
##-----#----#--#
#--------------#
#--------------#
#--#-------.---#
#------------#-#
#--------------#
#------#-------#
#--------------#
################