################
#--------------#
#-----$--------#
#--------------#
#--------------#
##-------------#
#--------------#
#------#-------#
#------#--.----#
#----#-----#---#
#------#-------#
################