################
#------#--#----#
#----.---------#
#----#---------#
#--------------#
#--------------#
#---------$----#
#--------------#
#--------------#
#--------#-----#
##-------------#
################