################
#--#-----------#
#--------$-----#
#-----#------#-#
#------------#-#
#------------#-#
#--------------#
#---#.---------#
#--------------#
#-----------#--#
#--------------#
################