################
#-----------#--#
#------$-------#
#-#--#---#--#--#
#--------------#
#--------------#
#--------------#
#--------------#
#--------------#
#----#----.----#
#--------------#
################