################
#--------------#
#--------------#
#--------------#
#------------.-#
#--------------#
#--------------#
#----------#---#
#-----$--------#
#-#---#--------#
#----------#---#
################