################
#--------------#
#--------------#
#--------#-----#
#--------------#
#------##------#
#---$----------#
#--------------#
##-------------#
#-----#--#--.--#
#--------------#
################