################
#-----#--------#
#--------------#
#----------#---#
#-----$--------#
#--------------#
#----------#---#
#--------------#
#--------#-----#
#--#---#--.----#
#--------------#
################