################
#--------------#
#--------------#
#--$------#----#
#--------------#
#--#-------#---#
#--------------#
#-----#--------#
#----------#.--#
#--------#-----#
#--------------#
################