################
#--------------#
##---$---------#
#----------#---#
#--------------#
#--------#-----#
#----------.---#
#----------#---#
#--------------#
#----#---------#
#--------------#
################