################
#-##-----------#
#--------------#
#-------------.#
#--------------#
#--------------#
#--------------#
#------------#-#
#----#---------#
#------$-------#
#--------------#
################