################
#------------.-#
#--------------#
#--------------#
#--------------#
#---#----------#
#----------#---#
#--------#-----#
#------------#-#
#----$---------#
#--------------#
################