################
#--------------#
#--$-----------#
#--------------#
#--------------#
#-----------#--#
#------------.-#
#--------------#
#----#---------#
#--------------#
#--------------#
################