################
#--------------#
#--------------#
#--------------#
#--------#-----#
#--------------#
#------------.-#
#---------#----#
#--------------#
#-------$------#
#--------------#
################