################
#--#--#--#----##
#------------.-#
#--#-----------#
#--------------#
##-------------#
#--------------#
#--------------#
#-------$------#
#--------------#
#--------------#
################