################
#--------------#
#--------------#
#--------------#
#-----------$--#
#--------------#
#--------------#
#--------------#
#--.-----------#
#--------------#
#--------------#
################