################
#---------#----#
#--$-----------#
#---#----------#
#---------.----#
#--------------#
#------#-------#
#------#-------#
#--------------#
#--------------#
#--------------#
################