################
#--------------#
#--------------#
#--------------#
#--------------#
##-------------#
#--------------#
#---------.#---#
#--$-----------#
#--------------#
#--------------#
################