################
#--------------#
#--------------#
#--------------#
#-----------$--#
#--------------#
#--------------#
#--------------#
#---.----------#
#--------------#
#--------------#
################