################
#-----------#--#
#--------------#
#--------------#
#--$-----------#
#--------------#
#--------------#
#--------------#
#--------------#
#---------#----#
#-----.--------#
################