################
#--------------#
#--------------#
#----.---------#
#--------------#
#--------------#
#--------------#
#--------------#
#--------------#
#----------$---#
#--------------#
################