################
#--------#-----#
##--$----------#
#--------------#
#-----------.--#
#-------#------#
#----------#---#
#----#-----#---#
#------------#-#
#--------------#
#--------------#
################