################
#-----#--.-----#
#--------------#
#--------------#
#--------------#
#--------------#
#--------------#
#---#----------#
#----$---------#
#--------------#
#--------------#
################