################
#--------------#
#--------------#
#--$---#-------#
#--------------#
#--------------#
#--------------#
#--#-#--------##
#----------#---#
#-------.#-----#
#--------#-----#
################