################
#-----------.--#
##-------------#
#--------------#
#------#-------#
#--------#-----#
#--------------#
#----$---------#
#--------------#
#--#-#---------#
#----------#---#
################