################
#--------------#
#--#-----------#
#---------#----#
#--------------#
#--------------#
#-----.--------#
#------#-------#
#-----------$--#
#--------------#
#--------------#
################