################
#-------.-#----#
#--------------#
#--------------#
#--------------#
#--#-----------#
#--------------#
#--------------#
#--------------#
#------------$-#
#--------------#
################