################
#--------#---#-#
#-----------$--#
#--------------#
#--------------#
#--------------#
#--------------#
#--------.-----#
#--------------#
#--------------#
#--------------#
################