################
#-#-----#------#
#--------------#
#--------------#
#--------------#
#--------------#
#--------------#
#------#--#----#
#--#----------.#
#--$----#------#
#--------------#
################