################
#-----#--------#
#--------------#
##-----------#-#
#--------------#
#--------------#
#----------#---#
#--------.-#---#
#--------------#
#--$-----------#
#--------------#
################