################
#---------.----#
#--------------#
#-----#--------#
#--------------#
#-#------------#
#--------------#
#--------------#
#------------#-#
#--------#--$--#
#--------------#
################