################
#-#------------#
#----------$-#-#
#--------------#
#--------------#
#----#---#-----#
#--------------#
#------------#-#
#-----.--#-----#
#--------------#
#--------------#
################