################
#--------------#
#------$-------#
#--------------#
#--------------#
#------------#-#
#--------------#
#------#-------#
#--------------#
#--------------#
#-.------------#
################