################
#--#------##---#
#--------------#
#-----.--------#
#--------------#
#--------------#
#--------------#
#------#-------#
#------------#-#
#-$------------#
#--------------#
################