################
#--------------#
#--------------#
#-----------.--#
#--------------#
#--------------#
#--------------#
#--------------#
#--$-----------#
#--------------#
#--------------#
################