################
#--------------#
#--------------#
#-----$--------#
#--------------#
#--------------#
#--------------#
#----------#---#
#-----------.--#
#-------#------#
##-------------#
################