################
#-----#--------#
#--------------#
#--.--#--------#
##-------------#
#---#----------#
#----#---------#
#-----#---$----#
#--------------#
#------#-------#
#--------------#
################