################
#--------------#
#--------------#
##--#----------#
#------------$-#
#----#---------#
#--------#-----#
#--------------#
#--------------#
#--------------#
#-----.--------#
################