################
#--##----------#
##-------------#
#-$------------#
#--------------#
#--------------#
#------------.-#
#------#-------#
##-------------#
#--------------#
#--------------#
################