################
#------------#-#
#---------$----#
#--#-#---------#
##-------------#
#------------#-#
#--------------#
#--------------#
#----.---------#
#------#-------#
##-------------#
################