################
#--------------#
#--------------#
#--------------#
#--------------#
#--------------#
#-----------.--#
#--------------#
#--------------#
#-$------------#
#--------------#
################