################
#--------------#
##-------------#
#--------#-----#
#------.-------#
#--------------#
#--------------#
#------#-------#
#--$-----------#
#--------------#
#--------------#
################