################
#--------------#
#--------------#
#----.---------#
#--------------#
#--------------#
#--------------#
##-#-----------#
#---------$----#
#----------#---#
#--------------#
################