################
#--------------#
#-.------------#
#-----#--------#
#--------#--$--#
#----#-#-------#
#--------------#
#--------------#
#--------------#
#--------#-----#
#--------------#
################