################
#-------#------#
#--------------#
#--------------#
#----.-#-------#
#------------#-#
#-----------$--#
#--------------#
#--------------#
#-----#------#-#
#--------------#
################