################
##-------------#
#--------------#
#---------$----#
#--------------#
#---#----------#
#--------------#
#--------------#
#--------------#
#--.-----------#
#--------------#
################