################
##-------------#
#-------.------#
##-------------#
#--------------#
#--------------#
#----#---------#
#--------------#
#--------------#
#--$-----------#
#--------------#
################