################
#-----#--------#
#--------------#
#-------------##
#--------------#
#-$------------#
#--------------#
#------#-------#
#-------.------#
#-----#-#------#
#--------------#
################