################
#---#----------#
#--.-----------#
#--------------#
#----------#---#
#--------------#
#------------$-#
#--------------#
#--#-----------#
#--------------#
#--------------#
################