################
#--------------#
#--------------#
#----$---#-----#
#--------------#
#--------------#
#--------------#
##-------#-----#
#----#--------.#
#--------------#
#--------------#
################