################
#--------------#
#--$-----------#
#---------#----#
#--------------#
#--------------#
#--------------#
#--------------#
##------------.#
#--------------#
#--------------#
################