################
#--#-----------#
#----------#---#
#-------.------#
#--------------#
#---------#----#
#--------------#
#--------------#
#--------------#
#---$----------#
#--------------#
################