################
#-----##-----#-#
#--$-----------#
#--------------#
#------#-------#
#--#-----------#
#--------------#
#--------------#
#--------------#
#-------------.#
#--------------#
################