################
#--------------#
#--------------#
#--------------#
#-----.--------#
##-##----------#
#--------------#
#----------$---#
#--------------#
#-------#--#---#
#--------------#
################