################
#--------------#
#---------$----#
#--------------#
#--------------#
#--#-----------#
#--------------#
#--#---------###
#--------------#
#-----.--------#
#--------------#
################