################
##-------------#
#--------------#
#--$-----------#
#--------------#
#-----##-------#
#--------------#
#--#-----------#
##-------------#
##-------------#
#---.----------#
################