################
#------#-------#
#----#------$--#
#---.----------#
#--------------#
#------#-------#
#--------------#
#--#-----------#
#--------------#
#--------------#
#--------------#
################