################
#-----#----#--##
#----------$---#
#--------------#
#--------------#
#--------------#
#--------------#
#--------------#
#--------------#
#------#-------#
#-----------.--#
################