################
#-----.--------#
#--------------#
#--------------#
#------#-------#
#--------------#
#--------------#
#------#-------#
#--------------#
#------------$-#
#--------------#
################