################
#-------------##
#--------------#
#--------------#
#----------#---#
#--------------#
#----------.---#
#--------------#
#--------------#
#---$----------#
#--------------#
################