################
#---#---#--#---#
#--------------#
#--------------#
#--------------#
#--$--#-----#--#
#--------------#
#---------.----#
#------------#-#
#---------#----#
#--------------#
################