################
#-----#--#-----#
#--------------#
#--------------#
#--------------#
#----#---------#
#----------.---#
#--------#-#---#
#--------------#
#--$-----------#
#--------------#
################