################
#-------#-----##
#---$----------#
#--------------#
#--------------#
#------#-------#
#----------#---#
#------.-------#
#--------#-----#
#--------------#
#--------------#
################