################
#--##--------#-#
#--------------#
#-----#--------#
#--------------#
#--------#-----#
#--------------#
#-----#--------#
#-----------.--#
#--$-----------#
#--------------#
################