################
#-------##-----#
#--------------#
#--#-------#---#
#------------.-#
#--------------#
#-$------------#
#--#-----------#
#--------------#
#--------------#
#--------------#
################