################
#----------#---#
#--------------#
#------------.-#
##-----#-------#
##-------------#
#--------------#
#--------------#
#-------$------#
#-#-#--#-------#
#--------------#
################