################
#----#--------##
#--------------#
#-------#------#
#--------------#
#--#-#----#----#
#--------------#
#----------#.--#
#--------------#
#----$---------#
#--------------#
################