################
#-----#-------##
#----.---------#
#--------------#
#--------------#
#----#-----##--#
#--------#-----#
#--------------#
#--------------#
#-----$--------#
#--------------#
################