################
#----------#---#
#--------------#
#---------$-#--#
#--------------#
#--------------#
#--------------#
#--------#-----#
#--#-----------#
#--------------#
#-----.--------#
################