################
#-----#--------#
#-------$------#
#----------#---#
#--#-----------#
#--------#-----#
#--------------#
#------##------#
#------------.-#
#--------------#
#--------------#
################