################
#--------------#
#--.-----------#
#--#---------#-#
#--------------#
#--------------#
#--------------#
#--------------#
#--------------#
#------------$-#
#--------------#
################