################
#---#----------#
#----------#---#
#--------------#
#--------------#
#------------#-#
#---------.----#
#--------------#
#--$-------#---#
#----#--------##
#--------------#
################