################
#---------.----#
##-------------#
#--------#-----#
#--------------#
#--------------#
#--------------#
#------#-------#
#--------------#
#----------#-$-#
#--------------#
################