################
#---#-----.----#
#--------------#
#--------------#
#--------------#
#--------------#
#------#-------#
#--------------#
#--$-----------#
#--------------#
#--------------#
################