################
#--------------#
#--------------#
#----#---------#
#--------------#
##-----###-.---#
#--------------#
#----$---------#
#--------------#
#------#-------#
#--------------#
################