################
#--------------#
#--------------#
#--------------#
#--------------#
#----------#---#
#---------.----#
#------#-------#
#--------------#
#----$---------#
#--------------#
################