################
#--------------#
#--------------#
#--------------#
#--------#-----#
#--------------#
#--------------#
#-------------.#
#-----$--------#
#--#-----------#
##-------------#
################