################
#-----------#--#
#--------------#
#--------#-----#
#------#-------#
##-----------.-#
#--------------#
#--------------#
#-----$--------#
#----------#---#
#------------#-#
################