################
#-------##-----#
#--------------#
#--------#---$-#
#--#-----------#
#--------#-----#
#--------------#
#--------------#
#--------------#
#--#-----------#
#-------.------#
################