################
#--------------#
#------#-------#
#--------#-----#
#--------------#
#--------#---.-#
#--------------#
#--------#-----#
#---$----------#
#--------------#
#--------------#
################