################
#---#----------#
#---------.----#
#--------#--#--#
#--------------#
#--------------#
#--------------#
#-----$--------#
#--------------#
#--------------#
#--------------#
################