################
#--------------#
#------$-------#
#--------------#
#--------------#
##-------------#
#--------------#
#-----#--------#
#---.----------#
#----#---------#
#--------------#
################