################
#--------------#
##-------------#
#--------------#
#--------------#
#--------------#
#----------#---#
#-------.------#
#--------------#
#-$------------#
#--------------#
################