################
#------#-------#
#----------$---#
#--------------#
#--#-----------#
#--------------#
#--------------#
#--------------#
#--------------#
#--------------#
#------.-------#
################