################
#--------------#
##-.-----------#
##-----------#-#
#--------#-----#
#--------------#
#--------------#
#------------$-#
#------------#-#
#----------#---#
#------------#-#
################