################
#-----#-----#--#
#--------------#
#--------------#
#--------------#
#--------------#
#--------------#
#--#-----.---#-#
#--------------#
#-$--#---------#
#--------------#
################