################
#-----------#--#
#--$-----------#
#--------------#
#------#-------#
#---------#----#
#--------------#
#----#-#-------#
#----------#---#
#---.----------#
#--------------#
################