################
#----------#---#
#-.------------#
#------------#-#
#--------------#
#--------------#
#--------------#
#----#-------$-#
#--------------#
#--------------#
#--------------#
################