################
##-------------#
#--------------#
#-------.----#-#
#--------------#
#--------------#
#--------------#
#--------------#
#--$---#-------#
#--#-----------#
#--------------#
################