################
#--.-----------#
#--------------#
#----#-----#---#
#--------------#
#--------------#
#----#---------#
#-------#------#
#---------$----#
#--------------#
#--------------#
################