################
#--------------#
#--------------#
#-----#----#---#
#------------.-#
##------#------#
#--------------#
#--#-------#---#
#--------------#
#---$----------#
##-------------#
################