################
#--------#-----#
#--------------#
#--------------#
#-------.------#
#--------------#
#--------------#
##-------------#
#---$----------#
#--------------#
#--------------#
################