################
#--------------#
#----.-------$-#
#---------#----#
#--------------#
#---#--------#-#
#--------------#
#--------------#
#--------------#
#-----#--------#
##-------------#
################