################
#--------------#
#--------------#
#-------#------#
#--------------#
#-----.--#-----#
#--------------#
#--------#--#--#
#-----------$--#
#--------------#
#--------------#
################