################
#-------#------#
#-$------------#
#----------#---#
##-------------#
#---------#----#
#--------------#
#--------#-----#
#--------#-----#
#---.----------#
#--------------#
################