################
#---#----------#
#--------------#
##---.---------#
#--------------#
#--------------#
#--------------#
#--------$-----#
#--------------#
#--------------#
##---#---------#
################