################
#--------------#
#--------.-----#
#--------------#
##-------------#
#--------------#
#--------------#
#----------#---#
#--------------#
#---$----------#
#--------------#
################