################
#-#------------#
#--#--------.--#
#--------------#
#--------------#
#--------------#
#--------------#
#--------------#
#---$----------#
#--------------#
#--------------#
################