################
#--------------#
##-------------#
#------##------#
#--------------#
#-------------.#
#----------#---#
#----#---------#
#--------------#
#--$-----------#
#--------------#
################