################
#---#----------#
##-------------#
#--------------#
#--------------#
#---#----------#
#--------------#
#------------#-#
#----.---------#
#---------#-$--#
#--------------#
################