################
#--------------#
#--------------#
#--------------#
#-$------------#
#--------------#
#----#---------#
#----#----.----#
#--------------#
#--------------#
#--------------#
################