################
######---#-#--##
##-----#-------#
##-##--#-###---#
##-$---#-----#-#
##-------#-----#
#------.-#---#-#
#-----##-#---#-#
##---------#---#
##$--#-##$.--#-#
#-.----#-------#
################