################
##--#---#---#--#
##-.$----------#
##-###-----###-#
##--.-------$.-#
##-#---#-#--#--#
#--------#-#-#-#
#-#--#-###$#-#-#
#------------#-#
##-##-#####----#
##-------------#
################