################
##----#---######
#--#--------.$-#
##-.---#----$#-#
##-#---#-------#
##-#---##-##-#-#
#--#-----#-----#
#--#-#-$-#-##--#
##-#--.------#-#
#--#-----#-----#
##-----#---#---#
################