################
####---#--##--##
#--#------.----#
#----#$###-----#
#----------#---#
####-##$-###-#-#
#-----------.--#
##-----#-#-#-###
##------$------#
##.#-#-#--##---#
#--------------#
################