################
###--#-#-----#-#
##-$-#---------#
##-#--######-#-#
#--#.----#-----#
##---#-----#--##
#--------.-----#
#--##-----#--#-#
#--------#-----#
#-$#-#$#---###-#
##--.------#---#
################