################
##-#-##-----#-##
#------.-$--.--#
#------#--#-##.#
##----------$-$#
#--###-#--#-##-#
#----#-#---#---#
##------##-#-###
#--------------#
##-#-##--#---#-#
##---------#---#
################