################
#-###---#--#--##
#----------#---#
##---#-###-#-#-#
##---#$----#---#
##-----#-#-#-#-#
#------------#-#
##-#-###-----#-#
#----.---#--$-.#
#--###-$-###-#-#
#---.----------#
################