################
#--###--###---##
##-------$-----#
##-#-###-#-----#
##-----#-----#-#
#--#-#-#-##-##-#
#--#-#-------$.#
##-#---##-#--#-#
##--------.----#
###------##----#
#----------$.--#
################