################
#--###-#---#--##
##-----#-------#
##-###---###-#-#
#-----$--#-.-#-#
##---------$##-#
#-------.------#
#--##--$-##-##-#
##-#---.-#-----#
##---#####-#---#
#--------------#
################