################
####--##-#--#-##
#--#---$-------#
##----######-#-#
#--#---.----.--#
##-#-##$##-#---#
#----------#-#-#
###-####.$-#-#-#
#--------------#
#--#----##-#---#
#--------------#
################