################
#-###-###--#-###
#--#---.-------#
##-#----$--#-#-#
#----.---------#
#--#-##$.#-----#
#--------#-----#
#--#-#-#-#-#-#-#
##-$-#-#-------#
##-#-#-#-#-#-#-#
##-------------#
################