################
#---###-#-######
#--------------#
##--###--#--##-#
##--$----#-----#
#-##-----------#
#----#-#---.---#
##-###-#--######
#------#---#---#
#--#-$#--#-$-#-#
##------.---.--#
################