################
#----##-##--####
#--$-#---------#
#-.#-#-##-##-#-#
##$#-#-----#---#
##-#-#-#-#-#-$-#
#-----------.--#
##-#--#-####---#
#--#------.----#
#-------###----#
#--------------#
################