################
#-##--#-##--#--#
#-------$-.----#
#-##---####--#-#
#------------#-#
#---##-#---#---#
#------.-#-----#
##-#####-###-#-#
##---.---#-----#
##-$-#---$-###-#
#--------------#
################