################
#######-######-#
##-#-----#-----#
##-#-#---#---#-#
##---#-#---#---#
####---.-------#
#-----------$#-#
#--------#-#-#-#
#---.$-#---#$--#
##-----##--#.--#
#----#---------#
################