################
####---#-#--#--#
#--#---------$-#
#--#--####--#-.#
##-------#-----#
#####--#$#---###
#------$-------#
#--#-.--##-#---#
##---------#-#-#
#--#---##----#-#
##-#--.--------#
################