################
##--#-----##-#-#
#------------#-#
#-#---##-#-#-#-#
#------.-------#
##-#-#-#-$-#---#
#--#-#---------#
###--#-$##-###-#
#----#---.-----#
##-#-#-##--##$-#
#--------#--.--#
################