################
###-#-.--#---#-#
#----#---------#
##-#----#-##-#-#
##-#---#---#---#
##--#-#-#$-#.$-#
#----------#---#
##-#---#-#####-#
##-------------#
##-------$-###-#
##----------.--#
################