################
###-#-#--###--##
##------$------#
##-#-#---###-#-#
#----------#-#-#
#------###-----#
#------.--$--.-#
#-##-#-#-#-.-$-#
#--#-#---#-----#
##---#---#-#---#
##-----#-----#-#
################