################
#-#--###-#-###-#
#----#-#-------#
#-##---#-$.#---#
##---#-$---#---#
##--$-##.--#---#
#--#-#-------#-#
#----.-#-#-----#
#----#---#-----#
#---###--#--##-#
#--------#-----#
################