################
##--#####-#--###
##-#-#---------#
##-#-----#-##$-#
#--#-$---#---.-#
##-###-----#--##
#-------.----$-#
#--#-------#---#
##-------#----.#
###-#---####-#-#
##-------------#
################