################
#--##-#--#----##
##----------.--#
##-$##-#-------#
##-------$-.---#
#--#-##-##-#-#-#
#--------#---#-#
#---#$-#--#-##-#
##--.--#-------#
##-#-##--###--##
##-#-----------#
################