################
##-##-#-#--#--##
##-#-----------#
##-----#--#--#-#
#---.--------#-#
##---#.$##-##--#
#--#-#-----#-$-#
#--##--#-###---#
#------------.-#
##-###-#-#-$#--#
#--------------#
################