################
##-###-#---##--#
##----------$--#
##-#-#-#-####--#
#------#-#-----#
#--#-#---#-##--#
#-----.------.-#
###--#----#-$--#
##--$#-#-----#-#
##-#.#####-----#
##-------------#
################