################
##-#-##-#--##-##
##-#-----------#
##--.--#-#-###-#
#---$----#---.-#
#-#--##-##-$#--#
#------------#-#
##-#---##$##---#
#----#-#-------#
#-#--#-#-##-#.-#
#--------------#
################