################
####--#---#-##-#
#------#-------#
#--###.#-#---###
#------#-------#
#----#-##--##--#
#--#-------#---#
#----#-$#--#-#-#
##-#-----#--.--#
##-#-#-#-#--$--#
##-----#-$---.-#
################