################
#-----#-#-######
##---.-$---#---#
##-#--####-#---#
#--#-----#---#-#
##---#-----#-#-#
#------#-$-#-#-#
#----#--.#---#-#
#--#-----#$#---#
#--#-##---.----#
##-------------#
################