################
##--####--##-#-#
#--#-------#---#
##-#-#-##----#-#
#----#---#----.#
##-###----##---#
#------#-$-----#
##-#-$#--###---#
##-------.-----#
#---##-#----#--#
##----.$-#-----#
################