################
##---#####--#--#
#--------------#
#---##---#---#-#
#------#---#---#
##-#-$-###-#---#
#----#-#---#-$-#
#--#--$.-#-#--##
#----#---#-#-.-#
##-----#-#-###-#
#-.--#---------#
################