################
###--#-###----##
#--#-------$-.-#
#-.$-####--#-#-#
#--------#$----#
####-###---#-#-#
#------#-------#
##------#-#--#-#
#--#-----------#
#--#---##-##-#-#
##-----.-------#
################