################
######-$.-###-##
##-----------$-#
##---#-#-#-#---#
##-------#---#-#
##-####----#-#-#
#------#---#-#-#
#------#-$.#---#
##-#-----------#
##--##---------#
#----.---------#
################