################
#-####--#-######
#----------#---#
#----#-#-#-##--#
#--#-----#-----#
##--##----##---#
#------#---#---#
#--#-#-#-#-$---#
##-#---#----.--#
##---##--##----#
#---.----$.$---#
################