################
###-#-##-#-##--#
#--------#-----#
#---#-$--#-#-#-#
##-----#-#---.-#
#-#-$##--##--#-#
#--------------#
##-###-#.$--##-#
#--#-----#.----#
#--#---###-#-#-#
#--------------#
################