################
#-#-##-##-######
#---.----------#
#-$#-------#---#
##---#-#-#---.-#
###-#--#-##$-#-#
#----#---#---#-#
##------#------#
##-------#-#-$-#
#--#---#-#---#.#
##-#-------#---#
################