################
##--##--#-#-##-#
#-$--#---------#
#--.-#-###-#-#-#
#--#---------.-#
##---###$#---#-#
#----$---------#
##--#--###--##.#
##-------#-----#
####-#----###--#
#--------------#
################