################
#--$.-#-#--#####
##----.$-------#
##-#-#---#---#-#
##---#---#-----#
#--###-----#-#-#
#----#---#.----#
###------#-#---#
#--#---#-$-#---#
##----##-###---#
##-------------#
################