################
#--####-##-#--##
##---------#---#
##---#####-#---#
##-.-----#---#-#
##-#-$-#---.---#
#------$-----#-#
#-#$##-#---#---#
##-----#-.-----#
#--#-#---#-##--#
##-------------#
################