################
#------##---##-#
#------.-$-.---#
##-$####---###-#
##-.---#-------#
##-####-$--#-#-#
#--------#---#-#
#--#-#-######--#
#----#-#-------#
#--------------#
##-----------#-#
################