################
#-#-----###-#-##
#------------.-#
#------#-#--##-#
#--#---#---#---#
##-#-###-#-#---#
#--#---------#-#
##-#-##$-#-##--#
#----.---------#
##-###$#----##-#
##-.---$-------#
################