################
#--###-#--###--#
#----#---------#
#-$#-#---#-#-#-#
#------------#-#
#--##-####-#-#.#
#--------------#
##-#-#-$.#-$-#-#
#----#---#.----#
#--#-###-#-#-#-#
##-------------#
################