################
##---##-##--####
#--------#-----#
#--#-#-------#-#
##-#----.#-#---#
##-#-$-#------##
#----#---------#
##-#-.-###--#--#
##-#-$---#---#-#
##-#--#$-###---#
##----------.--#
################