################
#-#-#-#-###-##-#
#--------------#
#--#-###.##----#
##--.--------#-#
###-####---#---#
#----#----$-$.-#
##---#--#--#---#
#------#---#---#
#---#--#-#-$-#-#
##-------#---#-#
################