################
#####-#----#####
##-------------#
##.#$#-##------#
##-------------#
#--###-###---#-#
#--------------#
###-#-##-#-----#
#--#-----#-#---#
##---#$$##---#-#
##---.------.--#
################