################
##--##---#-#####
##---.--$------#
##---#-###-###-#
##-#-----.-#---#
##--##-$---#-#-#
#------#---.---#
#-#--##-$#-----#
#------------#-#
#-----###----#-#
##-------------#
################