################
#-#--#----#-#--#
#------------#-#
#------#---#-#-#
#--#--.--------#
#--#-#--$.-#---#
#------#---#-$-#
##-#-$-##--#--##
##-#--.--#---#-#
##-#-###-###-#-#
##---#---------#
################