################
##-#-###-----###
##-#-------#---#
##---#---###---#
#--#--.$-----#-#
##-#-#----#-#--#
#--#-#--.#---#-#
##-#-#---------#
#----#---.-#-$-#
##----#$#--#-#-#
#----------#---#
################