################
####----#------#
#--#--.------#-#
##---#####-#---#
##-#---#-----#-#
##---#-###---$-#
#--#-----#.----#
##-#-###----#--#
#-------$----$-#
#--#-#--.--#---#
#----#-----#---#
################