################
#-##----##-#####
#--$---------#-#
#-##.--###-#---#
#-----------.--#
##-$##.###-$#--#
#------------#-#
#-#--#---#-#-#-#
#--#-----------#
##---#-#-#---#-#
##-----#-------#
################