################
#-#-#--#-##-##-#
#------#-------#
#--------#.#-#-#
##-----#-#---$-#
#--#--.#-#-###-#
#--------------#
##-$-###-#---###
##-----------#-#
####-----#-$##-#
##-----#---.---#
################