################
##-###-##------#
#--#-----------#
##--$-##-##----#
##-#-------#---#
##-##-##-$.-##-#
#--------------#
###-#-##-#--.#-#
##-------------#
#--#--####-###-#
##--.$---------#
################