################
#--######-##--##
##---#---------#
#-----#-----##-#
#--#-#-.-----$-#
##---#---#-#-#-#
#-----.--$-#$--#
##-##-#-#---.#-#
##-------#-----#
##-----#--####-#
##-------------#
################