################
####-###-####--#
##-----.-------#
#--#---##---#--#
#------#-------#
##-#####-#-#-#-#
#----------#-#-#
##--##--##-.-#-#
#----.--$---$--#
#--#--#--##--$-#
#--------#-----#
################