################
#-##-#--#------#
#--#---------#-#
##-#---#-###-#-#
##-----#-------#
#-#----#----#--#
#------#.#$----#
##-###---#-$---#
##-------#---#-#
#--#-$##--####.#
#-----.--------#
################