################
##----#--####-##
##-#-----------#
##------##-#-#-#
##----$--.---$-#
#####------$-#.#
#----#---------#
#------#.#-###-#
##---#-----#---#
##-##---##-#-#-#
##-------#-----#
################