################
##-###-##--#--##
#--------------#
#-#--#--######-#
##---#---#---#-#
#--#-#-----#-$-#
#--#--$----#.--#
##-#-####----#-#
##-------#-----#
##---#-$---.#-##
#-------.------#
################