################
####-#-#--######
#-.$-----------#
#-#-##-#-#-###-#
#----.-----#-#-#
##-#---#--##-#-#
#---$----------#
##----#----#-$-#
#------.-----#-#
##--##--#-##-#-#
##---#---------#
################