################
#-#-##-#--#-####
#----#---------#
#-#--#--##--.#-#
#------.-#.$---#
#---#$##-#---###
#------#-#-----#
##---##--#-#-$-#
##---#---------#
##-#---#-#---#-#
#--------------#
################