################
##--------######
#----#---------#
###--#---#-##$.#
#--#-------#-$-#
#---#-##-###---#
#------#---#.#-#
##--#---##---#-#
#----#-$-#-----#
###--#---#-----#
##--------.----#
################