################
######--#--##--#
#----.---------#
##-##--#-#-----#
##-----#-----#-#
####---#.###---#
#---$--#---#---#
#--#-------###-#
##-----#---$-.-#
#--#-##---#-$--#
#----#---------#
################