################
#--#--#--#######
##-#---------#-#
##----##-##----#
#----$---------#
#-##---#-$-----#
#-----.-------.#
##-##-##----##-#
##-#-----#-#---#
##-#-##--#-#---#
##-.$----------#
################