################
#---#--#--##---#
##-------#-----#
#--#-###--$-#--#
#------#.#-----#
##-#-$.#-##--#-#
#----#---------#
#--#--#-#$-###-#
##---#-----#---#
##---#---#.#-###
#--#-----#-----#
################