################
###--##----##-##
##-------------#
#--#-#---#-#---#
#--#-#-----#---#
##-#--#-##---.-#
#----#-----#---#
##---#$#-#----##
#-----$-.--$---#
##-#-###---#--.#
##---#---------#
################