################
#-##----#--#--##
#--#.$-#-$-----#
##-#-#-#-#-#---#
##---#---#-----#
#-##------##-#-#
#----#-#---#---#
##-#---#-#-#---#
#--#-#---#--.--#
##-#-##$-#-----#
##-------.-#---#
################