################
##-###-#-#--####
##----.--------#
####---##--#---#
#---.$-----#---#
##-#-##-----##-#
#--#---------$-#
##-#---#---#-#-#
#--------#-----#
#---###-##--$.-#
##-------------#
################