################
#-#####-#####-##
#---.----#---.-#
##-#-#-#-#-----#
##---------$---#
##-#---------#-#
#----------#-$-#
#-##-#-#-#-#-#-#
##-------#---#-#
##-----##-#-##-#
#-.$-----------#
################