################
##-##---#---##-#
##-#-.---#-----#
##---------#-#-#
##---------#-#.#
#--###--$#---#$#
#------#---#---#
#-###-#####--#-#
#---------.----#
#---#-##-#-$-#-#
##-------------#
################