################
##-#-#-#####-#-#
##--.----------#
#----$-##-$#-#-#
#------#-----#-#
#----#-#--#$####
#------#-.-----#
##--#----#-#---#
##-------#---#-#
#----#-#--####-#
##---.---------#
################