################
#-#-----#-$.---#
#-#--#--#------#
#-#--#--#--#---#
#----#-----#-.-#
#----------#---#
#-----------#--#
#--###-##-#-#--#
#--$----###-#--#
#--------------#
#---###--$.----#
################