################
#-#--#-#---##-##
#----------#---#
###-$---##---#-#
#----#-#-#---#-#
##-##----###-#-#
#-----------.#-#
##-#------##---#
#----#-----#---#
#---##-##--#---#
#----.$-$.---#-#
################