################
###---#-####-###
##-------------#
#----#---#-#---#
#--#---.---#---#
##---#--#-####-#
#----#---------#
##---#-----#$$-#
##-----#---#---#
##--####-#--##-#
##-----.---.$--#
################