################
#--##-####----##
#------#-$.$---#
##-#-#---#-#---#
##-#-#---#-----#
#----#-#----#--#
#------#-#----.#
####----###--#-#
#------------#-#
##---#-#-#--.$-#
##-#-------#---#
################