################
##-#---##--##--#
##---------#---#
#--#-###-###---#
##-----#--.----#
#--###-#---#---#
#----------$-#.#
#--#-#----#--#-#
##-$-#-------#-#
##.$-#----####-#
#--------------#
################