################
#####---#--##-##
##--.$---------#
##-#---#-#-#-#-#
##-----#.#-#-#-#
##-#-----------#
#-$----#-#---#-#
##---#---##-#--#
#--#-----------#
#--##---#-#-##-#
#------$.------#
################