################
#####---###-#-##
#--------------#
##---##-##-###-#
#-$------------#
##-#-#---#--##-#
#--#-$-----.---#
#--#.###-#-#-#-#
#--#---#---#---#
#----#-#------##
#--.$----#-----#
################