################
#####-###--##-##
#-------.------#
##---#$--$-#-#-#
##-#---------#-#
#--#-#---#--##-#
#---$-----.----#
#----.##-#-----#
#--#---#-#-#-#-#
##-------#---#-#
##---#-------#-#
################