################
#--###-#---#-###
#----#---------#
##.#-#-###-#---#
##-----.$--#---#
##--#--#$#-##--#
#-----------$-.#
#--##---##---#-#
#--------------#
#--#-##--#-#####
#--#-----------#
################