################
##-#-#-#-##-##-#
##-#---#-------#
#--#-$-###--#--#
#--#-.---------#
##-#----#--#-#-#
#----#-.-------#
#-###--------#-#
#--#---#---$---#
#--#-#-#-##.$--#
##---#---------#
################