################
####-#-#-####-##
#--------------#
#-##----#---##-#
##---------$---#
##-#.--###---#-#
#----#---#-#---#
#--#-#---#-$.--#
#--#---#-#-#---#
#---$##----#---#
##---.-#-------#
################