################
#-#-##--#####--#
#----#-#--.----#
#--#-------#$#-#
#-$--#---#-----#
#--###-#----##-#
#--#-----------#
##--#$#---######
#--#-----------#
#-.#-#--.##-##-#
##-------------#
################