################
#######-#--#####
#----#-----$.--#
##---#-###-#---#
##-#-#---#-----#
##-$-##-$--#---#
#--------#-----#
##-#---.-#---#-#
#----------#-#-#
#--###---#-----#
##-----.-------#
################