################
#-##--#-#--#-#-#
#--------------#
#----#-#-###-#-#
#--#-#---------#
##--##-#-#$-#-.#
#--#---#-------#
##-#-$##-####-##
#--.---#-----#-#
##-#-#--#-#-$--#
##-----------.-#
################