################
##---#######---#
##-#-----------#
#--#-#-#-.-----#
##---------#---#
####-##$-#-#---#
#--#-------#-#-#
#--#-#-##----#-#
#-$--#.#-#.----#
#--------#--#$-#
##-------------#
################