################
##----#---#-####
##-#--------$.-#
##.--#-#---###-#
#----$-#-----#-#
#---#--#-##----#
#------#-$-.-#-#
#--#-----##----#
##-#---#-#---#-#
#--#-#-#-#-##--#
#--------------#
################