################
###--#-#---#####
##-#.$---.-----#
#----#---###--##
#----------#---#
#-#####-##-#---#
#--------#-#-#-#
##-$--#-----##-#
#--#-#---------#
#---#--#-##----#
#---------$.-#-#
################