################
####-#----#--#-#
#-------.------#
#-$--#.#--#--#-#
#------#-------#
#--###-#---#--##
#----#-$.#-----#
#-##-#-#-####--#
##-------#---#-#
##-$##-#-#-#-#-#
#----------#---#
################