################
##-######-##-#-#
#-----------.--#
#-###-$-##---#-#
#------#-------#
#--##-##---.##-#
#---$----------#
##---#-$-#-#---#
#----#-.-----#-#
##--#-##-#-----#
##---------#---#
################