################
#--##-#-#--#--##
##---------.---#
##-#----#--#-#-#
#----------#---#
##-#-#--$-##---#
#--------#---#$#
####-$###---##.#
#----------#---#
##-###---------#
##-.-----#-----#
################