################
#####--##-##---#
#-------.----#-#
#-#$#-#####----#
#------------#-#
##-#-#-##-##-#-#
#----#$--#-----#
#------#-.---#-#
#---------$--#-#
###-##--#--.-#-#
##-------------#
################