################
##-#--##--##--##
##-.-----------#
#----##--#--##-#
#--$-#--.----#-#
##-#----##-###-#
#--#-----------#
##---#---####-##
#----#-#-----$-#
##-#------#--$.#
#------------#-#
################