################
#--#-#####-#-#-#
##--------.----#
#--##--##-#--#-#
##---------#-#-#
#-##---------#-#
#----#$#-------#
##--##-#-#---#-#
#----#------$.-#
##-$-###-#---#-#
#---.----------#
################