################
#----#--#-#--#-#
##---#-#--.----#
###--#-#-----#-#
#--#-------.---#
#----#-#---#-#-#
#----------#-$-#
##-#-#-#--##-#-#
##-$-#-$-----.-#
#--#-###-#-##--#
##-------#-----#
################