################
##-##-#-----#-##
##-------------#
###-#-###--#-#-#
#--------------#
#--##--#####-$-#
#---------$----#
#--#.--#-#-#-###
##-------#-----#
#--#-#.#-##----#
##-----#-.$----#
################