################
#---###-##--##-#
#---------.----#
#----####$####-#
#----#---------#
#--#-#-#-#-#-$##
#--#-#-$-#---.-#
##--##---#---#-#
#---------.----#
#--#-##---#-##-#
#--------------#
################