################
##---##--####-##
##-#-----------#
#-----.---#--###
#----#-#-------#
###-##-$-#-#-#-#
#------#-----#.#
##-#-$-####----#
#----$------.--#
#--#-#-###---#-#
#--------------#
################