################
########--##--##
#--------------#
#-##$#-#-#-----#
##----.--------#
#---##-#-$-##--#
#---$----------#
##-###-###---#-#
#------.--.----#
##-------##-##-#
##-------#-----#
################