################
##-####-####---#
#-$----------#-#
#----#---##--#-#
##-----#-#---#-#
##-#-#-#-#-----#
#--#-----#-----#
##-----#-#--##-#
#--------#--.$-#
#---##-#-#.#####
#----------$-.-#
################