################
#--#-#-#####-#-#
##-.---#-------#
#---##---#-$.-##
##-$-$---------#
##--#--##-##-#-#
#-----------.#-#
#--#-##--#---#-#
##-#-#-----#-#-#
#----#--##-#-#-#
#------#-------#
################