################
####-###-###-###
##-#-----------#
##---#--###-.#-#
#---.----------#
####-$-##$-#---#
#--------.-----#
#-$#-#---#--##-#
##-------#-----#
#-#---#-##-#-#-#
#--------------#
################