################
#########-##--##
#----#---------#
#-##-#-#-#-###-#
##---#-#----$--#
#----#---##-$--#
#------------#.#
#--##---#------#
##---.-------$-#
##-#-#-#--##--.#
#--------------#
################