################
####---##-#----#
##-#---#-$-----#
##---#-#--#-#--#
##-#---#----$--#
##-#-----##.-#.#
#----#---#-----#
#-#-#----#-#-#-#
##---#-------#-#
#--#---#--##---#
##----.$-------#
################