################
###-##-###----##
#------#-------#
#-##---#--#-.--#
#-----.--------#
##-$-#-$-##--#-#
#--#-----#---#-#
##-##--#-----#.#
##---#-----#---#
####-#-##---$--#
##---------#---#
################