################
#######---#--#-#
#------#-------#
###-##------#--#
##-#---#-------#
#----.#-.#-----#
#--#---#-------#
##-###---#--#--#
#--$-#-----#---#
#--#-#####-$-###
#----------$-.-#
################