################
##--#--##---####
##-------------#
#--####--#-#.$-#
#------#-----#-#
#-#--#$#--####-#
#-------.----#-#
#---###---##---#
#--#-------#---#
##--$-####--#--#
##----.--#-----#
################