################
#------###-#-###
##--.$-#-----#-#
#-##-#-#.--#-#-#
#----#-----#---#
#--$-#-#-#---#-#
#--------------#
####---#-----#-#
##-----#-------#
##-###--#----#-#
##----.-$--#---#
################