################
#-#---#-#####-##
#----#---------#
####-#-#-----$-#
#---------.#-.-#
##-##--#---##--#
#------------#-#
#--#---###-#-#-#
#-$----.-----#-#
##-#-##$#----#-#
##-------------#
################