################
#-##-#-#####-###
#--------------#
#####----#-##--#
#---$.-#-#-----#
#-$#--#----.-#-#
#--------------#
#-##-#$#-----#-#
##-------#-----#
##-#---##-.--###
##-------------#
################