################
#--#--######--##
##-#--------$--#
##---#-#$##--#-#
#----#-------#-#
##-##--#-###-#-#
#--------.-----#
#-----.###-##$-#
#----#-----#-.-#
##----------##-#
##-------------#
################