################
####-###-##-#-##
##-------------#
#--#-#-#-#-#$#-#
##---#-#-------#
##-#####-##-$#-#
#------#-------#
#------#.--$-#-#
#------#---.---#
#--##---#--#-#-#
##-------.-----#
################