################
##-#-##-----##-#
#--#-------#---#
##-#-#-#---#-$##
##-#-$---------#
#--#-------###-#
#----.---#---#-#
#-#-###----#-#-#
##-------.-$.#-#
#---#-####-#---#
#--------------#
################