################
#-#---###-#---##
#----#---------#
###--#-#-####--#
##---#-$-#-----#
#----#-#-#-##--#
#------.---#---#
##--#$#$##---#-#
##----.--------#
##--##-#----##-#
#-----------.--#
################