################
##-#--####--#-##
##-----.-#-.---#
##-#-#-$-##--#-#
#--#---------#-#
#---#--###-#-#-#
#----#--$------#
##---#---##--###
#----#-------#-#
##---#--#-$----#
#--#--------.--#
################