################
####--#-####---#
##-#-----------#
#--#--------#-.#
##-#-#-----#---#
#--#--$##-#-$###
#------#-#-----#
#--##--#-#-.##-#
#----#---#---#-#
##-#-----#-#-#-#
#------#-$-.---#
################