################
##--#-######-###
#--------.--.--#
#-.#-##$$##--#-#
##-------------#
#----#-###$#-#-#
#----#---------#
#---#---####---#
##---#---------#
##---###-#-#---#
##-----------#-#
################