################
#-#----##--#--##
#----#--$--#---#
#-#--#-#----$#-#
##-#------.--.-#
##--####---#-#-#
#------------#-#
##-#-#-----###-#
##-------------#
##--####-#####-#
##----------$.-#
################