################
###-#-.--#-##-##
#----------#---#
##-#-----------#
#------#-#---#-#
##-#-#-#--#--#-#
#--#-----#-----#
##-#-###-$--####
#------#---$.--#
#-##----####$#-#
##---------.---#
################