################
##--#-#--#---.-#
#--#---#-$-$---#
#--#---#-#.#-#-#
#--#-----#---#-#
#------#-##-#--#
#----#---#-#-$.#
#--#-#####-#-#-#
#--#-#---------#
#------#-#---#-#
#--------#-----#
################