################
#-###--##--##-##
#--#----.------#
#--#-#-#-$#--#-#
#--#.#-----#---#
#-$#--#--#--##-#
#----#-------#-#
#--#------#--$-#
##---------#.--#
###-##-#-#---#-#
##-------------#
################