################
#---#####-##---#
#--------------#
#--#-##----#-#-#
#--#--$--------#
##-#-#####---#-#
#----------#-#.#
#--#-#.---#--#-#
##--$----#-----#
######---#--#$-#
##---------#-.-#
################