################
#--##-----#--###
##-#--------.--#
##------#---##-#
#----#-----#---#
####-##-$#-#-#-#
#--------------#
#--###-##.-###.#
#--#---#-------#
##-#-#-----#$$-#
#----------#---#
################