################
#-.-###-#--#--##
##---#-------#-#
#-$--#.####--#-#
##-#-----------#
##--##-$#--#---#
#--------------#
#--#-#####---#-#
##-----.-$-#---#
##-#-----#-#---#
##-------------#
################