################
##-#-#-#--##-###
##-------------#
##--#$-#-------#
#--.---#-------#
##-#########-#-#
#--------------#
#---##-#-$---#-#
#----.-----$---#
#--#-###----.###
##-------#-----#
################