################
##-#-#--##-#####
#----------#---#
#--#-###-#-#---#
##----.------#.#
##--#-##-------#
#-----------$-$#
##----#-##-#---#
#---.--$-#---#-#
##-#-----#-##--#
##-------------#
################