################
#-#####-##-##--#
#----#------$--#
#-------#-##---#
##---------#.--#
##--.#---#-#-#-#
#--------------#
#--#-##---#-##-#
##--$--#-----#-#
##-#-$-###-###-#
##----.--------#
################