################
##---##--#-#-#-#
##-$.$---.-----#
##-#-#-#--##---#
#--#-#---------#
#--##----------#
#----#-------#-#
###--#---#--#--#
##---#.#-------#
##-##-$#-#-#-###
##-----#-------#
################