################
#--#-----##--###
#--------------#
##-###------#--#
#--#------.--#-#
##---#-#-#-#---#
#--#-$-#---#---#
##-#-#-#---#--##
##--.--$-#-#---#
###-#--##---#--#
#-----$-----.--#
################