################
##---##-#--#-###
#--------#-----#
##---##------#-#
#----------#.--#
##-#-###-#-$-#-#
#--#-------#---#
#---#---####-$-#
#--#-#------.--#
##-.$--#-#-#-###
#----#---------#
################