################
####--#--#-##-##
##-----------.-#
##-#-###---#-$-#
#--#-----#-#---#
##-#-#-------.-#
#----#-------#-#
#---###-#-###--#
#-----$----.-$-#
##-#-##-#--###-#
#----#---------#
################