################
#--#--#--#-#####
##-----.-------#
#-#--##$##-----#
#--------.---#-#
#--#-#-#--###--#
#--#---#-------#
##---#--$####--#
##-#-#-----#---#
#----#--$.-#-#-#
##---#---#-----#
################