################
#--#---#----#-##
#----$-#-------#
#-###-----##-#-#
#----#-#-------#
##--#--#---#---#
#------#-#.#---#
#--#$###-#-#---#
##-.---------#-#
#--#-#####---#-#
##-----.$------#
################