################
##-######-#--###
#-----------.--#
#-####------##-#
#------------#-#
##---#.#-#-#---#
#-$------#---#-#
##-#-#-$-#---#-#
#--------#$----#
#----###-#.##--#
#------#-------#
################