################
##----#-###-####
##-#-.-$-------#
##-#-##-.$-#####
##---#---#-----#
#-#-#-$###-#---#
#--#-----------#
#--#-###--##-.-#
#----#---------#
#----##--------#
#--------------#
################