################
#---##-#---#--##
#---.--#-------#
##---#---#-##--#
##---#-#-#-----#
##-----#--##$###
#------#-------#
#------$--####-#
##-#--.---.$-#-#
##-#-##----#---#
##-------------#
################