################
##-#-###--####-#
##-#-----------#
#--#---##-###--#
#--#---------$.#
#----#-.-####--#
#--#-#------.--#
#--###---##$-#-#
##----$--------#
#--#--##--###--#
##-------------#
################