################
#--#-#-#-#-#-###
#---------.#---#
####-###-----#-#
#-$------------#
#--##$##-#-----#
#----.-#-----#-#
#--#-###-#-#-#.#
##-------------#
##-$##--###----#
##---#---------#
################