################
#-##-#---#--#-##
#--#-----------#
#--#-###--#-#--#
#-$-------.----#
#--#-#-$-#-#---#
#----------#-#-#
#--#-#-#--##.#-#
##-----------#-#
##-#-#-$####-#-#
#-----.--------#
################