################
####--#-###--#-#
##-#-------#---#
#---####-#-$-#-#
##-----#-------#
#--###-$-#-##-##
#--------------#
##--#-.#--#-#--#
#--#----.------#
#-----#$####---#
#-.----------#-#
################