################
##-#---#--#----#
##-----#----.$-#
##---#-#-#--$#-#
##---#---#-#---#
#-#--#-#---#-$.#
#--#-----#-#---#
##-----#-#--##-#
#--#-----#-----#
#----#-###-#-###
##---.---------#
################