################
#-#--#---##-####
#-----.--------#
#--#-#####-----#
##---#---#--$--#
##-#---$-###---#
#--#---------#-#
#--#--#-##-#---#
#--#-.---#-----#
##-#---$-#-#---#
##---#-.---#---#
################