################
#-#-#--#--#-#-##
#--.-$$--------#
##-#----##--##-#
##-#------.--#$#
#---####-----#.#
#--------#-----#
##-###-###-#-###
#------#-------#
#--#---#-##-#--#
#--------#-----#
################