################
########--#--#-#
#--------.-----#
##---#-$-#-#---#
#----#---#-----#
#------#-#---###
#--#-#---------#
#--#-####$-#---#
#------.----.--#
#--#-$-#######-#
#--------------#
################