################
#####--####---##
##--------.----#
#--#-#--$##---##
#--#-----.-#---#
#---#--#----##-#
#----#---#-----#
##-#-#-$.--#-#-#
##----$--------#
##-##--#---###-#
##-------------#
################