################
##---######---##
##-------------#
###-#-$--#---#-#
##-#---------#-#
##-#-#-###--##-#
#----------#---#
#--###--#-----##
##--------.-$.-#
#--#--#--#-#---#
##---.-$-------#
################