################
###-#-#-##--##-#
##---------#---#
####---###--##-#
#----.---#---#.#
##--------##-#-#
#------------#-#
#-------##-$-#-#
##---------#-$-#
##--##-#$#---#-#
##-----.-------#
################