################
#####--####---##
##------.------#
##-##-------#--#
##---#-#-------#
#----#-#------##
#------#---$.--#
##---#---####--#
##$#---#-$-.---#
##-##----##--#-#
##-------#-----#
################