################
##-#-#-#--#--###
#--------.-----#
##-#-#---#-##$-#
##---#-#-$-#---#
#----#-#-###-#-#
#------------#-#
#----#--$---##-#
#------#----.--#
#-###-.#-#-#---#
#--------#---#-#
################