################
###-####-##---##
#----.----$----#
#-##-#-###-#---#
##----.#---#---#
##-#-#------$--#
#----------#---#
#--##--###---#-#
##---#---------#
##-#---#-#-#---#
##----.$-------#
################