################
#-#-#-#---##-###
#--.-$---#-$.--#
#-##---#-#--##-#
#--#---#-------#
##-----#--##---#
#----#-#-----#-#
##-##--#--##-#-#
##---------#---#
##-#-##$.---#--#
#--------------#
################