################
##--#-#####---##
#--------------#
#---#####--#---#
##-------#-.---#
##-##-#----#$#-#
#---$.-------$-#
##-#-##.---#-#-#
#--------#-#---#
##-###---##--#-#
##-------------#
################