################
##-#####----####
##---#---------#
##------#.-#--.#
#----------#---#
##--#####------#
#------#-$-----#
#-#-$#---##--#-#
##-----$-------#
##--##--##-#---#
##-----.---#---#
################