################
#-#--#-##-#-#-##
#-------.------#
#----#-##-###--#
#----.---------#
##$--#-###$$##-#
#--------.-----#
####-###-#-#-#-#
#--------#-----#
##--##-#----##-#
##-------------#
################