################
##--#---####-###
##-$----.------#
##--#$##----#--#
##-----#-------#
###-##---#####-#
#--------------#
##---####-#----#
#--------------#
#-##-#-$--.#---#
#-----.--#---#-#
################