################
#-####----#--###
#--#-----.-#---#
#---.#-----#---#
##-------#-#---#
####--$#-$-#---#
#----------#---#
#--#---###-----#
##---#-----#---#
##-#-###---#-#-#
##---$.--#---#-#
################