################
##--###-##--####
#--------#.----#
#-----##-$-###-#
#--.-----------#
##-#---#--#----#
#--#-#---#---#-#
##-#----##-#-#-#
#--#-#-#-------#
#-$.--##-#-$-#-#
##---------#---#
################