################
#####-#-####-#-#
#--------------#
##-#--##------.#
##-----#---#---#
#--##---#---#--#
#--------#-----#
#--#-##--##----#
##-----#-$----.#
##-----#-$$#.#-#
##---------#---#
################