################
#---#--#--#-##-#
##---#.$-------#
#-.-$--#-##-#--#
#--#-$---------#
#--###---.-#---#
#------#-#-#---#
#---##-#-#-#-#-#
#--------#-#---#
####----##-#-#-#
##---------#---#
################