################
#---####-#--#-##
#--------------#
#-#-----##-#---#
#--------#-#---#
#--#-###$#-#-#-#
#--#--.------#-#
#--#--##-#.----#
#-$----------$.#
#--##-###-####-#
##-------------#
################