################
#-######-#-#####
#----------#---#
##---#------#--#
#----------.---#
#-#-#$##--###--#
#-------$------#
####-#-$-#-----#
##---#---#-#---#
##--##-#.----#.#
#--------#-----#
################