################
###--#-$--.-#-##
##---#---------#
##---#--####-#-#
#--------------#
#----#-#$$-#--##
#--------.-#---#
####---###-###-#
##--.------#---#
#----#-###-#-#-#
##-----------#-#
################