################
##--#--##-##---#
##----------$--#
##---.##------.#
##-#-----#-----#
##-#####-#-$---#
#----------#---#
##-##-$-##-#-#-#
##--------.----#
####--#--##-##-#
##-------------#
################