################
#-#-#---##-###-#
#--------#-----#
#-----#--##--#-#
##-#---#.----#-#
##---#-$-#-#---#
#------#---.---#
####-#-#-#$###-#
##-------#-----#
#--#---#-#-$---#
#----#-------.-#
################