################
##---#--#---####
#------#-------#
#--#-#-#.###-#-#
##-#---------$-#
#--#--$--#####-#
#----#-------#-#
###-##.--###---#
##-$-#-------#-#
#--.---#-------#
##---------#---#
################