################
##--##-#-##-####
##-#-------.---#
#-----#####--$-#
##---#---------#
##-----#-#-###-#
#--$-----#-#---#
#----#-----#-#-#
#---.------#---#
#--###---#---#-#
##------$--.---#
################