################
###---###--##--#
##---#-------.-#
###----##----#-#
##-#-#-------#-#
#------#--#-#--#
#------#-----#-#
##----##-#-#-#-#
##-----#$------#
##---#-$.---####
##-------#-$.--#
################