################
#####-#------#-#
#--#-.-$---#---#
#--#-##--#--##-#
##-----.-------#
#--#--#$#-##-#-#
#----#---------#
###--#-#-##----#
#------#-------#
##-#---##-$-##-#
##---.---------#
################