################
##--####----##-#
#--------$-----#
#--###-#-#-###-#
##-------#-#---#
#----##--#-#---#
#----.---------#
##--#-#--##---$#
##-#---#---#--.#
#--#-#$-##-#---#
##------.----#-#
################