################
###-#-###-----##
##-----#-------#
#--#-#-#----##.#
##---#$$-#---#-#
#--##--#---#-$-#
#--------.-----#
##-##-#---#-.#-#
##-----#---#---#
##-#-#-------###
##---#---------#
################