################
########-###--##
#------#-------#
###--#-#----.--#
#------#---#-#-#
##--#--#-$-#-#-#
#--#-------#---#
#---#-#-###----#
#-$#---------#-#
#--#--#-#-$--#-#
#-.--#------.--#
################