################
##-##--#--##-#-#
#-$.-#---------#
#--#-##--#-#-#-#
##-#-------#---#
##---#-##-----##
#----#-#-----$-#
#--#-#-####-#--#
##-#-#-.$------#
#--#-.--###--#-#
#--------------#
################