################
####-#-##-#--#-#
##---#--$-.---.#
#----#-$######-#
#----#---#-----#
#--#-#-#-#-----#
#--#-----#-----#
##-##.#--#--##-#
##-------------#
#---#-#--#-#-$##
#--------------#
################