################
##-###-$.-#-####
##-----#---.---#
##-##--#----#$-#
##--------$----#
##---------#####
#----------#---#
#---##-#--##---#
##--.------#-#-#
#--#-#-###-----#
##-------------#
################