################
#####-##--#--#-#
##---------#-.-#
##--##--##.#-$-#
##-------#-----#
##-#--##-----#.#
#-$--------#-$-#
##--##----#--#-#
#--------------#
#--#-#-----#---#
##---#---#-----#
################