################
##########-#--##
#------#-------#
###--#--#----#-#
#------------#-#
#--#---#---#-#-#
#------------#-#
#--###-$-#-#-#-#
##-.$-$---.#---#
##---#-.##-#---#
#--------------#
################