################
#####----#######
#--#-----------#
#----###-#-----#
#--#-----#-#-#-#
##-----#---#-#-#
#----#---#-----#
#-$#-#--#--#---#
##---#.--$--$.-#
###-----#.-#-#-#
##-------------#
################