################
###---.---#---##
##-#---#$------#
#--#--#---#-##-#
##-#-----------#
#--##-#.###----#
#------------#-#
###--##--#-#-$-#
##-----#------$#
##-#-#---##--#.#
#------------#-#
################