################
####---------#-#
##---#-----#---#
#--#---#-#---#-#
#--#-#-------#-#
##-#--##---###.#
#--#-----.-#-$-#
##--##$$-###---#
##---#----.--#-#
##----####-##--#
#--------------#
################