################
#--####-----#--#
#----#---$.----#
###-$-#.#----#-#
##-------------#
##-####-$--#-###
#----------#---#
##-#-##-##-#---#
##-#-#---------#
##-#-#--.-##---#
#--#---#-------#
################