################
##-##--#--##-#-#
#--#-------#---#
#--#-###.#---#-#
#--#-----#-#---#
##-$-$##-#-#---#
#------.-#-#-#-#
#-####-#-#-##--#
##---#---------#
#-------$-##-#-#
#--.-----------#
################