################
#-##-#-##--#--##
#-.$-#---------#
#-##-#-#$#.#-#-#
#------#-------#
##-#-#--##-###-#
#----#---#-----#
##---#--$----###
#--------------#
#-##-#-#-##--#-#
##---------.---#
################