################
##-##--#-----###
##-#-----------#
#--#-#---#-----#
##-----------.-#
##-#-##--#--##-#
#------$-#---#-#
#--##.$#--##-#-#
##-#-------#---#
#--#--#$#-###--#
#-------.------#
################