################
#######--#-##--#
##------$-.#---#
###---#-.---#--#
##-#-----------#
#----#-#-------#
#----#---#-----#
##-#--$--#-#####
##---#-#----$.-#
##------##--#--#
##-------------#
################