################
################
##-------#######
##.#-###-#######
##-----$---#####
##-#-#$#-#-#####
#----#---.-#####
####-#-###-#####
####-#--------##
####-#####-#####
####-#####-#####
################