################
#####-#---#-##-#
##--$----------#
#--#.#----####-#
##---#---#---#-#
#--#-##-#----#-#
#---$-----.----#
#----#--##---#-#
##-#-------#---#
##----##---#####
#---------$.---#
################