################
##-##-#-$.--####
#------.---$.--#
####-#--##-#---#
##-#-----$-----#
##-#-#-----#---#
#--#-#---#-----#
##-----#-#-#--##
#--#---#-#---#-#
##--##-#-#-----#
#------#-------#
################