################
#----###--##-###
#--#--.--------#
#----##---#---##
##-----#---#---#
#--#-#-#--####-#
#------------.-#
#--#-#-#$#-#-$-#
##-----------#-#
##--###----#-$.#
##-----------#-#
################