################
################
##---#---#######
##-#-#$#-#######
##-$-#-#-#######
##-#-#-#-#######
#--------#######
##-#-#.#########
#--------#######
##-#.#-#-#######
##-------#######
################