################
################
##------.------#
##.#-#-#$#-#-###
##---------$-###
##-#-#####-#-###
#----####----###
##-#############
##------########
################
################
################