################
###--###---#---#
##-------------#
##-#-$-#-#--##-#
#--------#---#-#
#--#-#-#.$-#-#-#
#--------------#
##----.#-###-#-#
##---#-$.#-----#
##-#-#-#--#--#-#
##-------------#
################