################
#--#--#-###-#--#
#------$-$.----#
#--#-#-#-#--#--#
#-------$---.--#
#--##--#-#-###-#
#----------#---#
###--#-#.###-#-#
##-#---#-#-----#
##-##---##--##-#
#----------#---#
################