################
################
################
################
##-----###---###
##-#-#-#####.###
#-$------------#
##-#####-#-#-#-#
##-#####-$-#---#
########-#.#-###
########---#---#
################