################
##-#--#--#-#--##
##-------#---#-#
#---#--#-----#-#
##-------#-#---#
#--#-------###-#
#----#---#---#-#
#--#--######-#-#
##---.--$-$.-#-#
#-#---##-$-##--#
#--.-----#-----#
################