################
################
##-----#########
####-#-#########
####-$-#-#######
####-#-#-#######
#----------#####
##-#-#-###-#####
##-------------#
######.#-#####-#
######-#--$--.-#
################