################
#######-##-###-#
##---#---------#
#--#---##---$.-#
##--.------#---#
#---#------$-#-#
#----#---#---#-#
#----#--#-##-#-#
##$#.------#---#
##-#--##-----#-#
##-------#-----#
################