################
################
##########---###
############-###
##---#####---###
####-#####-#####
#------------###
##-###-###-#####
##-###-$-----#-#
##-#####$#-#-#-#
##--##--.-.----#
################