################
################
################
################
######---#######
######-#-#######
#----#-------###
##-#-#-#.#-#-###
##-#---#-$.$-###
##-#####-#-#####
##---------#####
################