################
#--###-#-#######
#----#---------#
#-#--#-.-#-#-#-#
##-#.----#-#-#-#
#---$------#---#
#--------#---#-#
##-###-#--$--#-#
##-#---#-------#
#----##--#-#-#-#
##--$----.-----#
################