################
##-##-##-##-####
##-------------#
##-#-#-#--###--#
##-#-$-#-------#
#--#------.$--.#
#----#-$-------#
#-##---###-.-#-#
#--------#---#-#
##-#-#-#---#-#-#
##-------------#
################