################
##--#--##-#-####
#---$-----.----#
##-###-#-------#
#----#---------#
##-#--#--#-----#
#--#----------.#
##-###.#-###-#-#
##----------$--#
#--#$#--##-#---#
#----#---------#
################