################
##-#######---#-#
##-------------#
##-$.###-###--##
##-------------#
##-#-#-#.#--#--#
#--#-------#-$-#
##-#-----#-----#
##---#-$---#.#-#
#----#-#-------#
#------------#-#
################