################
######------##-#
##---#---------#
##-#----.#-----#
#--#-#---#-#---#
##-$---#-$.##--#
#----------#---#
#--##--#-##----#
##-#-----#---#-#
##-##----##--#-#
##-----#-$.----#
################