################
################
##---------#####
##-#$#-#-#.#####
##--$------#####
##-###-#.#-#####
#----#-----#####
####-###########
###------#######
####-#-#########
####---#########
################