################
##---###-##--#-#
##-------------#
#-#---##---###-#
#--#---.-----#-#
#--$-####-$#---#
#------#-------#
#----#-#--##-$-#
##-----#-----.-#
#--###-#####---#
#--------.-----#
################