################
##-###---#-#-###
#--#-.-$-#.#---#
##---###---#-#-#
##-------------#
#--###$##--##-.#
#--------------#
#-----#---$-##-#
#--------#-----#
#--##--##--#-#-#
#----------#---#
################