################
##-######--#---#
#----#-$.------#
###-$--#-#-##--#
##-------#-----#
##---#--##-#---#
#----------.---#
##----#--#-###-#
##-------------#
#--###----#-##-#
#--$.----------#
################