################
#--##-##-#-#-###
##------.------#
#--#-##----#-#-#
#----.---------#
##-##-$#-#--#--#
#--#-------.$--#
##---#--##-$-#-#
##-------------#
##-###-#####-###
#--------------#
################