################
##-####-##--#--#
#--#--$--------#
##-#-##--#-##--#
#--#---#-----.-#
#--#---#--##-#-#
#------#-$---#-#
##-#----#.#$#--#
#----#.--------#
##-#---#---#-###
##-----#-------#
################