################
#-#-##----#-#--#
#------#-#-----#
#------#-#---#-#
##---#.#-----#-#
##---#----##-#-#
#----#-$-------#
######-##---##-#
#--------.---$-#
#--#---###-#-#-#
#----------$.--#
################