################
####----#---####
#----#-----#---#
#--#----#--$---#
##-----.-------#
#--#--#####--#-#
#--------------#
#--##-###----###
##---------#---#
##----########-#
##----$.----.$-#
################