################
################
################
################
##---------#####
##-#-#-#.#######
#----.$-$--#####
##-#-###-#-#####
##---------#####
##-###-#########
##-###-#########
################