################
################
#########------#
##########-#-#-#
########---#-$-#
############.#-#
#----#######---#
##-###########-#
##-----###-----#
##-#$#####-#####
##--.------#####
################