################
##-###---#-#-#-#
#----------#---#
#---#--#-#--#--#
##-------#---#.#
#--#-#######-$-#
#----#-$-----.-#
#--#---#-----#-#
##---#--.#-$-#-#
##-#-#---#-----#
#--#-------#---#
################