################
###-##-----#-###
#--.---#.------#
#--$-#---###---#
#------------#-#
#####---##----##
#----#---#-#---#
#--#-#----###--#
##---$-#-------#
##-##---#-#----#
#----#---$--.--#
################