################
#-#-##---#######
#----#-$.--#-.-#
###--#-###-#-$-#
##-#------$----#
#---#--#-##--#-#
#----------#-#-#
#--#-#-##-#----#
#--#-----------#
#--#-#-----###-#
#------.-#-----#
################