################
###---#####--#-#
#----------#---#
#####-####-#.$-#
#------------#-#
#--##.--#$##---#
#--------------#
###--#--.#--#--#
##---#---------#
##--#-$--#-#-#-#
##---------#---#
################