################
################
####--.-$--#####
####-#-###-#####
#--------#-#####
##-#-###-#-#####
#------#-----###
####-#$#-#-#####
##-#----$-.#####
##-#.###-#-#####
##---###-----###
################