################
##-##---#-#--#-#
#----#----$----#
####---#-#-----#
##-#-#-.--$---.#
##----##--##-#-#
#--#-----#---#-#
#---#--###-#---#
##---------#---#
##--#------#-#-#
#----#---#-.$--#
################