################
##-#--#-##-###-#
#-.$-----------#
#-##-.#----#-#-#
#--#---#-#-----#
#---#-$#-##-#--#
#----------#---#
##-#--##.#-#---#
#--------#-#---#
#--#---#--$--#-#
##-----#---#---#
################