################
#-##-#-###-##-##
#--------------#
#---##-###--#--#
#----------#---#
###--##-.--#-#-#
#--#---#------.#
#---##-$-#-###-#
##-#-----#---#-#
#----#-#---$$#-#
##----------.--#
################