################
################
#########--#---#
##########-#-#-#
##########--$--#
##########-#-###
#----#####-----#
##-#########-#-#
##-.-----------#
##-#-#-#######-#
##--$.-#######-#
################