################
##-#-#--##-#--##
##-------------#
##--.#######---#
##-#-----------#
#----###-#-#-#-#
#--#$--------#-#
##-#-#-#-------#
##--.-------$--#
##-----#-#---#-#
##--$.-#-#-----#
################