################
#--#---#-#-#--##
#--------------#
#--#-----#-$-.-#
##-----#-------#
#-#####-####-###
#------------#-#
#--#$#####-##--#
##-----.----.$-#
#---##---#--##-#
##-------------#
################