################
#--##--#-#-#--##
##-------------#
#-#--#####-#-###
#--------#-----#
##-#-#-#.-####-#
#------#--$---.#
#---####-#-----#
#----------.-$-#
#--#-#-#-$-#---#
##-------------#
################