################
##---##---###--#
##-$.#------.--#
#--#-#-#----#--#
##-#---#-#-#---#
#---##-#-$-#####
#------#-------#
###--#-$-#--#--#
##---#---------#
#----###-#--.--#
##---------#---#
################