################
################
##-----#########
##-#.#-#########
##-$----.-######
##-#-#-#########
#-$----#########
####-#-#########
##-------#######
##-#-###-#######
##---###-#######
################