################
###--#####---#-#
#--$---------#-#
#--#-----##----#
##-#-#-#---#-$-#
#--#-#-#--#--#-#
#--#-----------#
#---#-#-.-##--##
#--#-----#-.---#
##----####-#-#-#
##--------$--.-#
################