################
####--##-##-#-##
##-----#-------#
###--#-#---##--#
#----#-----#-#-#
##-----##----#-#
#--#-----#-$-#-#
#---##$#-----#-#
##----.----#---#
#--$--#--#.---##
##-.-----------#
################