################
###-.-#-#--#-###
##-#-----------#
##.#-$--#---#-##
##-#-#---------#
##-$-##--------#
#------#-------#
##-#-----#####-#
##-------$-----#
#----#-#-#-#--.#
#----#-------#-#
################