################
#--####-##-#####
##-#-.---------#
##---#-#.--#-#-#
#--#-------$---#
##-#-$-#---#-#-#
#----#------.#-#
##-###-#--#----#
#------------$-#
##-#--##-#---###
##-------------#
################