################
##--###-#---#-##
##-.-----.-----#
##-##--#-##----#
#----#----$----#
##----#$-#--##-#
#--#-----#----.#
##---#$#-#-###-#
#------#-------#
##-#-####--#---#
#--------------#
################