################
##-#--##--#----#
##-----#-------#
#--.-------###-#
##---#-------#-#
#-#-##--#$.#-###
#--------------#
#-$-##-#-#-#---#
#---$.-#-----#-#
####---#-#---#-#
##-------#-----#
################