################
################
##------.----###
##-#$###-###-###
#-------.------#
##-###$#####-#-#
#-------####---#
############-###
############-###
################
################
################