################
################
#--------#######
##-#-#-#########
##-$-$-#########
##-#-#-#########
#--#--.--.-#####
##-#-#-###-#####
##---------#####
##-#-#-#########
#------#########
################