################
##---###-###---#
##-#.----------#
#----#$$.#-#-###
##-#-#-----#---#
#--#--##-#-#---#
#----#---#-----#
##-###-##---#--#
#------#-$----.#
#------#---#-#-#
#----#---------#
################