################
################
#--------------#
##-#-#####-#$#-#
##--------.----#
##-#.#$#########
#------#########
##-#############
##---###########
##-#-###########
##---###########
################