################
################
##---------#####
##-#-#-#-#-#####
##----.--------#
####-###-#-###-#
#--#.-$-$--###-#
##-#-#-#-#######
##-------#######
################
################
################