################
####-##----#####
##-------------#
#-----.-##-###-#
#------$-#-$.--#
##-#--##----##-#
#--#---#-------#
##-#-#--#--#---#
##---#$#---#-#-#
##.------#---#-#
#--#---------#-#
################