################
################
########---#####
########-#######
####---#-----###
####-#-#-#-#####
#--#--.--#-#####
##-###-#########
##---.--$--#####
######-#$#-#####
######------####
################