################
##-----------###
#--.---------#-#
##----#-$###-#-#
#--#-----#---#-#
##--####-#-#$--#
#--------#-----#
##----#--#.-##$#
#--#-#-------#-#
##---#-######-.#
##-------------#
################