################
#####-#-#---##-#
#------------#-#
####--##---#---#
#--#-#-----#-$-#
#--#-#-#---#--.#
#--#-----#---#-#
##$#-##$-#-#-#-#
#--------------#
#--#-###---#.#-#
#--#-.---------#
################