################
##--#-#-####--##
##-#-----------#
#---##-#-##-##-#
#--#-----.-#---#
##----.#$-----##
#-$--------#---#
##-#-#####-#-#.#
#------------$-#
##---#---#-#---#
##---#---------#
################