################
#-##--####---###
#----$---------#
#-----####---#-#
##-------#-----#
##-#-#-#--#----#
#------------#-#
##--##-#---###-#
##-------#-$---#
##-#--.$-#.#-###
##-----------.-#
################