################
################
################
################
##-#####--.--###
##-#######$#-###
#------#-#-#-###
##-#.###-#-#-###
##---------$-###
##-#-#-#########
##-----#########
################