################
###-###---##-#-#
#--------#-----#
##--.##-##-----#
#--#---------#-#
#--#-----#.--#-#
#--#-------#-#-#
#--##-##---#---#
##-----#-$$-$--#
##-#------##.#-#
##-------#-----#
################