################
##-###-#######-#
##---#-----.---#
###------#-----#
#--#---------#-#
#------#-$.----#
#----#-#-------#
##-#-#-#-####--#
#--------------#
##-##$###--#-$-#
##------.------#
################