################
################
##-----#####---#
##-#-#-#####-#-#
##-#-$-#####---#
##-#-#-#####-###
#--------.-----#
######-#-#-#-###
######-$-#---###
######.#########
####---#########
################