################
################
##---###########
####-###########
##---###########
##-#############
#--------#######
##-#.#-#########
#-----$-$-.-####
##-#-#-#-#-#####
##-----------###
################