################
################
##------------##
##-#$#$#-#######
#---.------#####
##-#####-#-#####
#--#---.-----###
##-#-###-#######
##---###-#######
################
################
################