################
##-#--########-#
##-#-----------#
#----##--##-.--#
##-#---#----$--#
#---##-#---#---#
#----#--$----#-#
#-#--#-#---#---#
#----#-#$----#-#
#------#-#.#---#
##-----.-----#-#
################