################
###-#-##-#---###
#--------.-----#
##---##$-#-#-#-#
#--------------#
##-#---#-#-#---#
#--#-#-#-------#
#--#-#-#-###---#
#--#---#-------#
#--###-#-#$$##-#
#-.--------.---#
################