################
###-####-##---##
#--------------#
#-##-#-###-#####
##--$----------#
##-$-#-##------#
#--#---------#-#
#------------#-#
##-#-#-#------.#
##.$-#-#.--#---#
##-----#-------#
################