################
################
##-#-----------#
##.#-#-#-###-###
#---.----###-###
##-#-#$#-#######
#------$-#######
##-#-#-#########
#------#########
##-#-###########
##---###########
################