################
################
##---###########
##-#-###########
#----###########
##-#-###########
#----#########-#
##-#-#########-#
#--------------#
##-#-###$###-###
##-.--.----$-###
################