################
################
##----##########
##-#############
##----.--#######
##-#-#-#-#######
#-$-.----#######
##-#-#-#-#######
##---#-$-#######
##-###-#########
##-------#######
################