################
##--###--###-#-#
##-------------#
#--##--#--#-#--#
##-----------#-#
#--##--#-#-#---#
#------#---#-#-#
#--#--###-$--#-#
##---------#--$#
##--.#-#-#$#--.#
#----#---.-----#
################