################
################
##---.-#########
##-#-###########
##----$--#######
##-#-#$#-#######
#-------.-######
##-#-###########
##-------#######
##-#-###########
##------########
################