################
###----##-#--###
##-#---------#-#
##----.####--#-#
##-#----.------#
##---#-$-$-##$-#
#----#---#-----#
####--##-#.----#
#----#---#-----#
#---#----#-#---#
##-----#-----#-#
################