################
##--####-#######
##$------------#
#-.-##---##--#-#
##-#---#---#---#
#-----##-#-###-#
#--$-----#--.$-#
#--##---#--#---#
##-#---------#-#
#--#---#--.----#
#----------#---#
################