################
###--###-###--##
#-------.--#---#
##-#-#-$#-----##
##---#---#-----#
#--##--#---#-#-#
#--#---#-----.-#
#--#-#---##--#-#
##-----------#-#
##-$---#----##-#
##-.-$-----#---#
################