################
################
#-----######---#
##-#-#########.#
##-#-###---###-#
##-#-###-#-###$#
#--#------.----#
####-#$#-#-#-###
###------#---###
##########-#####
##########-#####
################