################
################
####-------#####
######-#-#######
#--$-----#######
##-#-#-#########
#------#########
##-#-#-#########
#--.$-.--#######
##-#-#-#-#######
##-----------###
################