################
####----#-#-##-#
##-------------#
##-#-#-##------#
#----#---#----.#
#---#-#$-##-#--#
#--#----.------#
#--###-#-$-##--#
#------#---#---#
##---#-$-#---#-#
##---#----.--#-#
################