################
##-#-#--##--####
##-----#---#---#
#-#-##-##--#---#
#--------#-----#
#--#-##--$-##-$#
#--------#-----#
##--.#--###--#.#
#------------#-#
#--#-##-$.-#---#
##-------------#
################