################
################
####----########
####-#-#########
##------########
##-#-#-#########
#--#-#-----#####
##-#-###-#$#####
##---##--#-#####
##-#-#####.#####
##-#-$--.--#####
################