################
################
###----------###
####-#####-#####
##---#------####
##-###$#-#-#####
#-$-------.#####
##-#####.#-#####
##-#####-----###
################
################
################