################
##-#--##---###-#
##.--.---------#
##-#-----###---#
##---#---------#
##-----##$-###-#
#----#---.-#---#
#--#-#-$-#---#-#
##-----#-$-#---#
##-####--#---#-#
##-------------#
################