################
#-----#-#-#-##-#
##---#---------#
####-###---###-#
#--------------#
##---###----####
#----------#---#
#---##-.####---#
##------$-$-$--#
##--#---####.--#
##---.---------#
################