################
################
################
################
################
################
#--#---#-------#
##-#-#-#-#-#.#-#
#---------$-$--#
##-###.#-###-#-#
##-##----------#
################