################
##-#-##---#---##
##-------------#
#-#######--#--##
#--------------#
##---#-$###--#-#
#------.-------#
##---#-##-####-#
#---$--#-------#
#--#-$##--#-####
#--------.---.-#
################