################
################
##-------#######
##-#-#$#########
##-$----########
##-#-#-#########
#-----.#########
##-#-#-#########
#-.------#######
##-#-#-#-#######
##-#-------#####
################