################
################
##---------#####
##-#.###########
##-----.-#######
##-#-#-#-#######
#-$--#-$-#######
##-#-#-#########
##-----#########
####-###########
####--##########
################