################
###----#########
##-#------.----#
##-#-###$-#----#
##---#-----#.--#
#-#-#-$-#--#-#-#
#--------$---#-#
#----#.---#----#
##-------------#
##-#-#-----#-#-#
##-#-------#---#
################