################
################
######---#######
######-#-#######
##-----#----####
##-#####-#-#####
#--#####.------#
########-#-#-#-#
########-#---$-#
########-#$#-#-#
########----.--#
################