################
##--##-#---#-#-#
#--------------#
##-###-$.#-##--#
#--------#---#-#
#-#----#-##-$#.#
#--#---#-#-----#
#---##-#-#--#$-#
##-#---#--.----#
#----#-#-#---#-#
##-------------#
################