################
################
##-----#########
##-#-#-#########
##------########
##-#.#-#########
#-------$-$-.--#
##-#-###-###-###
#----#--------##
########-#######
########-#######
################