################
##-.$--#--##---#
##-------------#
######-#-#-#-#-#
##-------#.----#
#--#---#-$-#-###
#----#-#-$-#---#
##-#----##---#-#
##-------#.#-#-#
#--#-#---#-#-#-#
#------#-------#
################