################
################
##-----#########
##-#-###########
##---.-#########
##-#-#-#########
#-$--#---#######
##-#-#-#-#######
##---.$----#####
####-#-#-#######
####---#-#######
################