################
####-#-####---##
#--#-------#---#
#----#-----#-$-#
##-----#-------#
####-##---##-#-#
#------#-#-----#
#--#-#-#-#-#---#
#------.-------#
##-##--##--.-$-#
##-.$----------#
################