################
##----##-#####-#
##-------------#
#####---#-.----#
##---#---#-----#
#----#-#--$-.#-#
#--#-------#-#-#
#----$-##--#---#
#--#.--------#-#
#--#-#-##$##---#
#----#---------#
################