################
########---#-###
#-.$-----------#
##--#-##-#-#---#
##-------#-----#
##-#--$#--$---##
#----.---#-----#
##--####----#--#
##-#--.--------#
#--#-##-###----#
##-----------#-#
################