################
#----##--###-###
##---#---------#
##-#-#-#-##----#
#--#-----------#
##--##-#-#---#-#
#----#-----.---#
##-##--#.$##-#-#
#-$------------#
#--#---#-#--#--#
##-------#--$.-#
################