################
####---#-#--##-#
##-.-----.-----#
#--$-###-##--#-#
#----------#-#-#
###--#-#-#-$.#-#
#------------#-#
##---#--##-#---#
##---------#-$-#
##----##-#--#--#
#--------------#
################