################
###-#-------#--#
#----#-----#---#
##----##-#-#--##
##-#-.---------#
##-##--##.---#-#
#--------$--$--#
##-#--#---##-#-#
##-----#.------#
#----#-$-###-#-#
##---#---------#
################