################
####----###--###
##--------$--#-#
##-$###---##-#-#
##---#---#-#---#
####-#-.--.----#
#----#-#-------#
#------##--###-#
#--#---$.--#---#
##---##--#-----#
#--------#-----#
################