################
################
#----#####-----#
##-#-#####-#$#-#
##-----.-------#
##-###-###-#####
#--#--$-.--#####
##-#-#-#########
##-------#######
################
################
################