################
################
##----------####
##.#-#$#-#######
#--------#######
##-#-###########
#--------------#
######-#######-#
######--#--.-$-#
################
################
################