################
####-----#-###-#
#----#-.-------#
#-#--###---##--#
##-#-#---#-----#
#--#-#-#---#-#-#
#----#-#---#-#-#
##-#-#---$##-$-#
#------#.------#
##-#-$#----###-#
#--------.-----#
################