################
#--##-------#--#
#----#---------#
##-#.---######-#
##-#---------#.#
#--#-##--#-#$#$#
#--------$--.--#
##-##--#-##--###
#------#-------#
#--#####---#-#-#
##-------------#
################