################
#------#-##-####
##-----#-------#
###-.#---###-#-#
##------$------#
#--#-#--#---#$-#
#-----.--------#
#--######----#-#
#-----$-.--#---#
##--###-##-###-#
##-------------#
################