################
#########---####
##---#-.-------#
##----#-$--$-#-#
#----#-------#-#
#--##--##-$##--#
#-----.---.#---#
#--#-#---#----##
#--------#-----#
##-#-#-#----##-#
##-------------#
################