################
#######--#-#####
##----.-$------#
###--#-#-#-#-#-#
##------.#---$-#
#--##----------#
#-----$.---#---#
##--#----##--#-#
#------#-----#-#
##---#-#---#-#-#
#--------------#
################