################
##--##---##-#--#
#------#-------#
##-##----#-#-$-#
##---#---#-#-.-#
##-#-#-###-#-#-#
#-$---------$--#
##----##.-#--#.#
##-------#---#-#
#--#-#-#-------#
##-#-------#---#
################