################
###-####-#-#-#-#
##----.--------#
#-#---#--####--#
#-------$--#---#
#--#--#----#---#
#--#-----.-#---#
#----###--#--#-#
#-$--#---#-.$--#
##-#---#---#-#-#
##-----#-------#
################