################
#--###---#---###
#-.$-----------#
####---#-##--###
##-------------#
#---#---#-###--#
#--#-------#-$-#
##---#.--#-#---#
#----#---#---#-#
#---#-##-#####-#
#-------.$-----#
################