################
#-#-####-###-#-#
#----#----.----#
#-#-----##$###-#
#--.-#---------#
##----#--------#
#----------#-$-#
###--#-##--.-#-#
##---------$-#-#
#----###-##-##-#
#--------#-----#
################