################
################
##-#-----------#
##-#-#-###-#-###
##-.$-$------###
##-#-#####-#####
#-----####-#####
##-#.###########
#----###########
################
################
################