################
#-#-###-##--##-#
#----$---------#
##--##-#-----#-#
#--#--------.--#
#--#-$#-##-#-#-#
#----------#---#
##---#.-#$-#--##
#----#---.-#---#
##-#-#---####--#
#--#-----------#
################