################
#-#--##-#--#####
#-----.$---#---#
###--#---#-#.--#
##---------#-#.#
#----###-#-$-$-#
#----#---#---#-#
#-#--------###-#
##-------------#
##-#-#-##--#---#
#--------------#
################