################
################
########-------#
########-#####-#
########-#-----#
########-###-#-#
#--#####--$.---#
##-#########-#-#
##-----.-----#-#
##-#$#-#########
##-----#########
################