################
################
##----------####
##-#-#.#-#######
#--------#######
##-#-#-#########
#-$--#---#######
##-#-###-#######
#--------#######
##-#-#-#########
#---.$-#########
################