################
################
##---.$--#-#####
##-###-#-#-#####
#-----$----#####
##-#-#-#-#######
#--#-----#######
####-###.#######
####------######
######-#-#######
######-#---#####
################