################
################
####-------#####
####-#-#$#-#####
##---------#####
##-#-###########
#----.-#########
##-#-#-#########
##-#---###---###
####-#-###$#-###
####-.-------###
################