################
#---###--#--##-#
#--------$.#---#
#---##-#-#-###-#
#----#---------#
##-#-#-#-#-$-#-#
#--#--.#-------#
##-----#-#--#--#
##-------#---#-#
#--##--#-$.#---#
#------#---#---#
################