################
##-#-##-####---#
#-.#-----#-----#
##$#---#---###-#
##---#-------#-#
######--##-----#
#----#-#---#---#
#--#---##-##-#-#
#--$-#.----.---#
#---$---#------#
##-------------#
################