################
################
##########-----#
############-#-#
##-$-----------#
##-#####-###.#-#
#--#####-------#
##########-###-#
##########---#-#
##########-#-#-#
######---.$----#
################