################
#--###--##--#-##
#--------#-----#
###------##---.#
#-----.-------$#
##--###------#-#
#--------------#
##--#-##.#-##--#
#--#-------$-#-#
##-#-#$#-###-#-#
##---------#---#
################