################
######---#-###-#
##-#-------.---#
##-#-#--#$-#---#
##-#-$.----#-#-#
#--#-##-##-----#
#--------------#
#--#--##--##-#-#
##---#--.------#
##-#---#-$-###-#
#--------------#
################