################
################
#-------.-######
####-#-#-#######
##--------######
##-#-#-#-#######
#-$--.$--#######
##-#-###########
##-----#########
##-#-#-#########
##-----#########
################