################
################
##---###---#####
##-#-###-#.#####
#------------###
##-#-#$#-#-#####
#----------#####
##-#-###-#######
##--.-$--#######
##-#############
##-#############
################