################
##----#--###--##
#--------------#
##.-##---###-#-#
##$-$--#-----#-#
##-#------#--#-#
#--------------#
##-##-#--------#
##-$----.#-#---#
##.#-###-#-#-#-#
##-#-------#---#
################