################
#-#-####-#---###
#-----------$--#
#--#-----#.--#-#
##-#-#-----#---#
#---##-#--#-.#-#
#----------#---#
#-$--###----#--#
##-----------#-#
##-##-#$#--#-#-#
##------.------#
################