################
######-----#-###
#----------.---#
#--#-#---#-#-#-#
##-$--.--#-#---#
#--###-#-#-#-#-#
#---$------#---#
#--#---#-###-#-#
#------#--$.---#
#--#-#----####-#
#--------------#
################