################
###-##-##-####-#
##-------------#
##-###-#-----.-#
##-#--.----#---#
##-----#$-#-$--#
#--#-----#-$---#
##---######.##-#
##---#---------#
##---------#---#
##---------#---#
################