################
#-##--#---#-#-##
#--#-----------#
##-##----#---#-#
##---#-#-------#
##-#--.###.#-#-#
#--#---------#-#
##-#---#$#$--#-#
#--#-$----.#---#
##-#----#--##--#
##---#---------#
################