################
######-#-##-####
#--------------#
#----#-#-###-#-#
##-----#-------#
##-#---#-#-$#--#
#----#--.------#
##-#-$.---##-$-#
#--------#---#-#
#----#--#--#.--#
#--#-----------#
################