################
#-------#-######
##--------$.---#
##-#-#-#-###-#-#
#-$------#-#---#
##-#-#-#---#---#
#--#---#.--#---#
#--#---#-------#
#----#-#---#---#
#--$-#-####-#--#
#--.-#---------#
################