################
#----#--#----###
#---.----------#
#######-#-#--#-#
##--$--------#-#
##--###--#---$-#
#----#--.----#-#
#---##-#-#--##-#
#------#-#-$.--#
#---####-#--##-#
#--------------#
################