################
################
##-------#######
##-#-#-#########
##-#-$-#######-#
##-#-#########-#
#-----------.--#
##########-###-#
##########-.---#
##########-#$###
##########----##
################