################
#--##-##---#####
#--------.---#-#
#-#-#-####-----#
##-------#-----#
##----#--#--##-#
#-$--------.---#
###--#---#--#--#
#----#---#-#-$-#
##----##-#-$-.-#
#------------#-#
################