################
################
##-------#######
##-#-###-#######
##-#---$-#######
##-#.###-#######
#--$---#-#######
##-#-#-#-#######
#------#--######
##-#-###-#######
#---.-##--######
################