################
##-#--#--#-###-#
##----$--------#
##-----------.-#
#--#-#---#-----#
##---#-#-#--#--#
#------#.#-----#
#--##-##-##-$-##
##-----#-.$----#
##-##---##-###-#
#----------#---#
################