################
################
######---------#
######-#-#####-#
##-$----.$--##-#
##-#####-#-###-#
#--#####-------#
##-#####.#-#####
##-#####---#####
################
################
################