################
####-###-####-##
##-------------#
##$-#-#--##-##-#
#------#-#-----#
#--#-#-#---#--##
#-------.------#
##--##-$##--##.#
#----#-------$-#
#--#---#---.---#
#--#-----------#
################