################
################
##-------#######
##-###-#-#######
##-#-----#######
##-#-#$#.#######
#--#-#-#--######
##-#-#$#########
##---#-#########
####-#-#########
##----.---######
################