################
################
##---------#####
####-#-#$#-#####
####-.-.------##
####-#-#$#######
#--------#######
##-###-#########
##-----#########
##-#-###########
##-----#########
################