################
################
##########-#---#
##########-###-#
##---#####-----#
##-#-#####-###-#
#--#-$-----.-#-#
##############-#
############---#
############-###
#######--.$----#
################