################
################
##----.------###
##-#-###$#$#-###
##-----------###
##-#.###########
#-------########
##-###-#########
##-#---#########
##-#-#-#########
##---#-#########
################