################
#---###-#-#-#-##
##-----------.-#
#--##$##-#-#--##
##---$---------#
#--####$-#---#-#
#-----.----#-#-#
#------#-#-###-#
##---#----.----#
##------####-#-#
##-----------#-#
################