################
#-#####-#-######
#--#--.----#---#
#----##$-#-#.#-#
#--.-#---------#
###-##-##-##$#-#
#--------------#
##---#---------#
#----#-#--$--#-#
#----#---#-----#
#--------------#
################