################
##-#-#####-#-#-#
#----------$--.#
##-$-##----#-#-#
##---#---------#
##--##-#--#----#
#------#---#---#
###----###--##-#
#----#-#-#-#---#
#--.-----#---#-#
#------#---$-.-#
################