################
##-#----#----###
#--.---$.$-----#
####-#-##--.-#-#
##---#-#---#---#
##-#-#---###-###
#----$-#-#-----#
#----#-#-#-#---#
##-----#-------#
#---##-#-#--##-#
#--------#-----#
################