################
################
##-----#########
##-#$#-#########
##-----#---#####
##-#.#$#-#-#####
#------------###
####.#-#-#######
####-----#######
######-#########
######-#########
################