################
###-##-##-#-##-#
#--------------#
#--#-#-#-#-##--#
##----.----#---#
#---##-##$##.#-#
#--#-.-----#-$-#
##-------#-#-#-#
#--------------#
#--#---#-#-#-$-#
#------#-------#
################