################
################
######--$-.----#
######-#-###-#-#
######--$--.---#
########-#-#-###
#------------###
##-#######-#-###
##-#######-----#
############-#-#
###########----#
################