################
#-#------------#
#-.------#####-#
##$###---#---#-#
#----#---#.#-#-#
#----#####.#-#-#
#-------$--$-#-#
#-----------##-#
#--------------#
#-----####-----#
#--------------#
################