################
##-###-##-#----#
#--#-----------#
##----##-##-.--#
##-#-------#---#
##-##-##----##.#
#-$------------#
###$#-##-#---#-#
##---------#---#
#--#-#####-###-#
##-------------#
################