################
##--#----#--#--#
##-$-#---#-$--.#
##---###---#-#-#
##---------#---#
#--#-#-###----.#
#----#---------#
##-#----##-----#
##-------#---#-#
##-#-#-#---###-#
#--------------#
################