################
##---##--##---##
#--#-----------#
##-###-----#-#-#
##-----#-----#-#
#-#---#--#-$-#-#
#--#-#-$.#-#---#
#--#-#-----#---#
#------#-#-----#
##-###-#-#-----#
#------#-.---#-#
################