################
###--#----#-##-#
##-$-#.------$-#
##---#-#-####--#
#--#---------#-#
#--------#-----#
#--#-#-.-#-#---#
#--#---#---#-###
##-#---#-#-----#
#--#--#--#-----#
##-------------#
################