################
##-----#--##---#
#--------------#
####-#-#-#-#-#-#
##----.$-#---$-#
#--#---#-----###
#----#-#---#---#
##-#----##---#-#
##---.---#-#---#
#--#-----#-#---#
#------#-------#
################