################
####-#-###---#-#
#--------------#
##-----#--####-#
#----#-----#-#-#
#-#--#---#-#-#-#
#----.---------#
##-------#-#-$-#
##------.----#-#
#--#-#----##-$-#
#--------------#
################