################
#-------##-#-#-#
#-$----#-------#
##---#-$-#-##.-#
##-#-----------#
#--#-#-#-#-##--#
#----#---#----.#
#--#-###-#-###-#
##-----#-------#
#-##---#---#---#
#--------------#
################