################
#--##--#-#####-#
#.-------#---#-#
#-#------#-$-#-#
#--#-.-----#---#
#--##--#----#-##
#------#-------#
##-#--#--###-#-#
#--------------#
#--#--###---$--#
##-------------#
################