################
#----#--#--##--#
#--.-----.-----#
#----#-#---#-$-#
##-----#---#---#
##----#--###-#-#
#-----------$--#
##-#-#-#-#--##-#
##-#-#---#-----#
#----#--##-#####
#--------------#
################