################
#---##-#----##-#
##-$-------#---#
#---#--#-#-###-#
#----#---------#
##-#-#-#--#----#
#--------#-----#
#--###---#---#-#
#------------.-#
##---#--.-#--$-#
#--------------#
################