################
#---##-##-#-#--#
##-.---------#-#
#----##--##--#-#
#------#-------#
#---#-.#-----#-#
#------#-----#-#
##---#-#-#-##--#
##---#---------#
###--#-$-#-$#--#
#------#-------#
################