################
###-###-##--##-#
##-------#-----#
#------#-#--#$-#
##-#-#---------#
#---#--#-###-#-#
#----#$#-----#-#
##--------#--#-#
##-.-#-----#---#
##-##---.----###
#--------------#
################