################
##--#--#####--##
#------#-------#
#--#---#-#-##--#
#--------#-#---#
#----#.----#---#
#--------#-#---#
##---####--#-#-#
##----.----#-#-#
###-##$#$#-#-#-#
#------------#-#
################