################
####-########-##
#--------------#
#--#---#--##-.-#
##-#---#-#-#---#
#--#-----#-#---#
#--#$#--------.#
##-------##----#
##---------#---#
#------###-$-#-#
#----------#---#
################