################
#-#--###-##-##-#
#------#-------#
#------------###
#--#-------#---#
#--#--.##--#-$-#
#--#-$--.------#
##-##--#---##--#
##---#-------#-#
##-#--##--#----#
#--------#-----#
################