################
##---###--####-#
#--------------#
#----#-#---#$$-#
##---#-----#---#
##--##--#-#-##.#
#------#-------#
#------#-##-##-#
##---#-------#.#
##--#---##-##--#
#--------------#
################