################
#-#-##---##--###
#--------------#
#--#$#-#---#-#-#
#-------------.#
#--##$-#--####-#
#------#---.---#
##-###-#--#-##-#
#----#---#-----#
#--#--####-###-#
##---------#---#
################