################
######-#-------#
##-#-----------#
#----#-###-###-#
##-#---------#-#
#--#-##$-#-#-#.#
#----#-----.---#
##-#---###-###-#
##---------#---#
##---##-$#---#-#
#--------#-----#
################