################
#--#---#---#####
##---.---------#
##--#--#--####-#
#--------#-----#
#-#-.--#-#-###-#
#--$-#---------#
#--#-###--######
##-----#----$--#
#-#---------#--#
#--------------#
################