################
#####--#---#-#-#
#-.------------#
#--###-----#---#
##---.--$----#-#
#---####--#----#
#--------------#
#-------#-$-#-##
#----#-#-------#
####---#-#####-#
##-------------#
################