################
##-#--####--#--#
##-------------#
##-#---#-----#-#
##-----------#-#
######-----#--##
#--------#-.---#
#-$--#---##----#
#-------.----#-#
##-#--#--#-#$--#
#--------------#
################