################
#--###-###--#--#
##-#---------$-#
#----#####-#---#
#--------------#
#----#--##-#---#
#-------.----#-#
#--##$#-#------#
##-------#---#-#
#----#--.------#
#--------------#
################