################
##--#######--###
#----#--.------#
##-------#-##--#
##---$.#-------#
##---#-###--##-#
#----#-----#---#
##-#-##-#------#
##-#-#---#---#-#
##--$--#---#---#
#------#-------#
################