################
#--.--##--#-####
##---.$--------#
#--#-###--##-#-#
##-------------#
#----#-#-###---#
#--------------#
##--#----#--#--#
#----#----$----#
#-#--###----##-#
##-------------#
################