################
###-###-#--#--##
#----#------$$-#
#--#---##-###--#
##---#---------#
#-----##---#---#
#--------#-----#
#---.#----.--#-#
#--#---#---#-#-#
##---##-#----#-#
##-------------#
################