################
#####-.---#-####
##-------------#
##---.-#--#-##-#
##---#---------#
#--#-$-####--#-#
#----#-------#-#
##-#-#-##--#---#
#--#-------#-$-#
##--##-----#---#
#------------#-#
################