################
#-#-#-##------##
#------.----$--#
#-##-#-----#---#
##--.#-------#-#
#--#-#--#-##-###
#--------------#
#--#-#-###--$#-#
##-#-------#-#-#
##--##-#-#-#-#-#
##-----#-------#
################