################
#--###----#----#
#--#-----------#
##-#---##--##-##
#--$-#---#-#---#
#-##--##--$-.#-#
#------------#-#
##--####--.#---#
##-------------#
##--##-##----#-#
##-----------#-#
################