################
#--#--######---#
##---------#---#
##---#-#-#-$-#-#
#--#---#---#-#-#
#--#####--$--#-#
#------#-----#-#
##---#-#----##-#
##-------#-----#
##-#-#-------#.#
##-------.---#-#
################