################
#--###-#####-#-#
##-------------#
#--###-#-#-#-#-#
#--------------#
#-#-##--#-#----#
#------#---#---#
##-##--#-#-###-#
#----#-#.------#
##-#--#--$.#-$-#
##-------#-----#
################