################
########-##--###
#----#---------#
####-#--#--#---#
##-----------.-#
#---####-###---#
#----#-#-#-$.--#
#-----$----##--#
#--------#---#-#
##-###--#-#--#-#
#--------------#
################