################
##---------#-###
#------.-------#
#---#--#-----#-#
##---#--.#-----#
###--#-----#-$-#
#--------------#
#--#-#-#-#---#-#
##---------#---#
#--##$-#-#--##-#
##-----#-------#
################