################
########-####-##
#--#-----------#
#------#--##-#-#
#------#-#---#-#
#-#-#--###-###-#
#----#-------#-#
##$--#-----#---#
##----.------$-#
##--##---#-#--##
#-.------------#
################