################
##--#-#-#-##--##
#--.----.------#
#-#-##---##-$--#
##---------#---#
##--#----#-#-$-#
#--#-------#-#-#
##-#--#-#-##-#-#
#--#-#---------#
#--#--#---####-#
##-------------#
################