################
#----####-#--#-#
#--#---#-----#-#
#-----.###-#.#-#
#----#-----#---#
#--#-----#-#-#-#
#----#------$--#
#----------#-#-#
##-$---------#-#
##----####-###-#
##---------#---#
################