################
##-#-###--#-##-#
##-#-----------#
##-#-----#-#-#-#
##--------.#---#
##-#-#.#-#-----#
#-$--#---------#
#--#-#--#-###--#
#--------------#
##-$-#-#---#-#-#
#--------------#
################