################
#-#-#---###-#-##
#--------------#
##-#######--##-#
##------.----#-#
#-#----#---#-#-#
#--#-----#.--#-#
#-----##-#$##--#
#-$#-----------#
#--#-#-#--##-###
##-------------#
################