################
#---###---#-#-##
##---$---------#
##-#-#-#--##-#-#
##-#-#-----#-$-#
#----#-#-#-#-#-#
#--------#---#-#
##-#-----#--##-#
##----.--#---#-#
##.---#-##---#-#
##-------------#
################