################
######----###--#
#----#--$------#
#-##-$-####--#-#
##---#-------#-#
#--#-#---###---#
#--#-----------#
#----#--##-##--#
##---#-----#---#
#--###--.#--.--#
##-------#-----#
################