################
#---####----#--#
##-$-#---#-----#
#--#-#-#-----#-#
#--#-#-----#-#-#
#--#-#--#-#--#-#
#-$------------#
#---####----#--#
##-----------#-#
#-----.--#-----#
#----------.-#-#
################