################
#-----#--#######
##-#-----------#
##----#--#.###.#
##-#-#---------#
#--#-#-###-#-$-#
#--#-----#-#---#
##-#-#-#-#--$--#
##---#---#-----#
#--##---#--#-#-#
##-----#-------#
################