################
####--#---#----#
#--------------#
#-#----#-#---#-#
#----$---#-----#
##-#---#-#--#--#
#---$#-------#-#
###-.#---##-#--#
##-----#-------#
##-####-----#--#
#------.---#---#
################