################
#--##--#---#-###
#.-------#-----#
#-##--.--###-#-#
#------#-------#
##-#-#-$-#-----#
#--------------#
#--#-#-#-#-$---#
##-------#---#-#
#----#-##-#--#-#
#--#-----------#
################