################
##---#-#-#-#-#-#
#----------#---#
######-##--#-#-#
##-------.--$--#
#--#--.#-#---#-#
#--#-#-#-#-#-$-#
##-#---#-----#-#
##---#---#-----#
##-###-----#-#-#
##-----------#-#
################