################
##-###-##---####
#--------------#
##-#-$-##--###.#
##---#-----.-#-#
#---##--####-$-#
#--------------#
##---##--#--##-#
##-------------#
##-#---#-###--##
##-----#-------#
################