################
#---#----#-#-#-#
#---.----------#
##---#-#-$-##$-#
##-#----.--#---#
#--#-#---#----##
#--#-----#-#-#-#
##--#--#-#-#-#-#
#--------------#
##---#####-###-#
#--------------#
################