################
##----#--###-###
##-#--------$--#
#--#---##$##-#-#
##-#-------#---#
#--#--##-#-----#
#--#---------#.#
##---#-#--#----#
##-#-----#-.---#
##-#---#-#--#--#
#--------------#
################