################
###--#-#--###-##
##-------------#
#--##--#-----#-#
##-----#-----#-#
#--###-#-#-###-#
#--#---------#-#
##---#.##----$-#
##-------.--$--#
##-#---#-##----#
##-------------#
################