################
#--####----#-###
##-------#--.--#
######-#-#.$-#-#
##-----------#-#
##--####-###---#
#------#---#---#
#---#---#----#-#
#----#---------#
##$#----#-#----#
#------------#-#
################