################
##--#-#-#####-##
##-------------#
##-----#---#-#-#
#--#---#--$--$-#
##-----------#-#
#--------.---#-#
#--#----##-#---#
#-------.----#-#
#-----#-##-#-#-#
#--------------#
################