################
##-##--###--#--#
#--------------#
#---#---##----.#
#--------------#
#--##----#-###-#
#------------.-#
##-$-#-#--##-#-#
#--#-----#-----#
#--$-###-#####-#
##-------------#
################