################
#-----###-##---#
#--------------#
#-----##-#-##--#
#------#-$$#---#
#---##-------#-#
#--------#-#---#
#--#-------#---#
#----#---#-----#
#--#-#.#--####-#
##--.--#-------#
################