################
####--#----#--##
#--#-------#---#
##------##-----#
##---.-------#-#
###--###.##-##-#
#--------------#
##-------##--#-#
#--#-------#-#-#
#--#-#-#-#-#$$-#
##---------#---#
################