################
##-##--#---##--#
#-------.$----.#
#--#-###---#---#
##-#-#---#---#-#
#--------#-#-#-#
#--#-#---------#
#----#---###-#-#
##-#-#-#-----#-#
#--$-----#---#-#
#------#-------#
################