################
##-###--##-##-##
##-#-----------#
#----#-##-##-#-#
#---.--#-------#
##----------#--#
#--#---#-------#
#--#---##-#---##
##---.------$--#
#---#-#-$-#--#-#
#--------------#
################