################
#----#####--#--#
#--------------#
#-.--.--##----##
##-#-----#-----#
##--##---####--#
#--#-----------#
##-#-#--##-#---#
##---#---$-----#
##-----#$#-##--#
#--------------#
################