################
##-#-#-#--####-#
##----.--$-----#
#-#---#--#-##$-#
#--#-----------#
#--#---#--#----#
#----#-------#-#
#---##.###-###-#
##-#---#-------#
##-#####-#-#---#
##-------#-----#
################