################
#-##-###---#---#
#--#-----------#
#--##-$#-##----#
#----#----$----#
####-------###-#
#----#-#.----#-#
#--##------#---#
#---------.#---#
####-#-#---#---#
#----------#---#
################