################
#--##--###----##
##-#-----------#
##-----#-#--#--#
#------#-----#-#
#-#-##-#-#.#-.-#
#--#-----#-#-$-#
#--#---#-#-#--##
##-#---#-#-----#
#---$-------#--#
#--------------#
################