################
#--#-####-####-#
##---#-----.--.#
##---#-####----#
##---#--$------#
#--#--##$#---#-#
#--#-------#---#
##--##--#-##-#-#
#----#---------#
#-##-#---#-#-#-#
##-----#-------#
################