################
#---#-###----###
##---------#---#
####---#---#-$-#
##-------------#
#-----##-#--##-#
#--#---------$-#
#---------#--#-#
#------#-#-----#
#--##.##-#---#-#
#--.-------#---#
################