################
#---#----##-#-##
##-------------#
####-#----##-#-#
##-------------#
#----##----##-##
#--------------#
#--#----##--##-#
#--.-----------#
#--#-#-#$-###$-#
##--.----#-----#
################