################
###---###----#-#
##-#-----------#
##-##--#-------#
##--.-----.--$-#
##------#-#-$-##
#--#---#-----#-#
#--##--#--####-#
##-------#---#-#
#---#--#-------#
#--------------#
################