################
##-#-######----#
##---.-----#---#
#--#--------##-#
##-----#-#-----#
##----##-#-##--#
#----------#---#
#--##-$#---#-$##
#----.---#-----#
##----##-#---#-#
##-#-------#---#
################