################
###--#######---#
##--$--#-$-----#
##---#-#-#-#-#-#
#--#-#-----#---#
##-#---###-.---#
#--------------#
#--#---#-##--#-#
##-------#-.---#
##-#--------####
##-------------#
################