################
#----##-.----#-#
#--#---------.-#
#--------#-#---#
#------------#-#
#----#-###-###-#
#----------#---#
#----##----#--##
##-#-#---------#
#-$#-$-#-##-#--#
##---#---------#
################