################
####--#-##-###-#
##-#-----------#
##-#-####-##---#
##-------------#
##--#------#-#-#
#----------.---#
##---#-#-.#----#
#--#-----------#
#--#-$----#-$#-#
#--------------#
################