################
#--#-.-----#####
#-.------------#
###-----#--#-#-#
##-#-----------#
#--#-----##-$-##
#------#-$-#---#
#------#-#-#-#-#
#--#-#-----#---#
##--#--###-#-#-#
##-------------#
################