################
#----###-###-#-#
##-----#-------#
#-#----#-#-#-#-#
#------------#-#
##-#.----#-$-#-#
#--#-----------#
##-#---#-#-#-$-#
#-----.#-#-#-#-#
#---#----#-#---#
#--------------#
################