################
####---#-##---##
#----#---------#
##-#--#--##----#
#-$--#-------#-#
#--##--##$-#---#
#------#---#---#
#--#-----.-##--#
##-#-#-#-#-----#
##----.--#-##--#
##-------#-----#
################