################
#####-###-#-##-#
#--------------#
##-#-#---#-#-$-#
##-------#-#---#
#####----#-----#
#----------#---#
##-----##.---#-#
##-#-----$-----#
##--###---.#-#-#
##-------------#
################