################
##---#--#---####
#------#-------#
#--#-#-#-###-#-#
##-#-----------#
#--#-----#####-#
#----#-------#-#
#-#-##.--#-#-$-#
#----#-------#-#
#-----------$--#
##-.-------#---#
################