################
##-##---#--#####
#--------------#
#--###-----#-#-#
##-------#-----#
#-#-####-##-##-#
#------------#-#
#-------#$-#---#
##--.------#---#
#----#.#$###-#-#
#------#-------#
################