################
#---###-##----##
##---#----.----#
#--#---#-----#-#
#----#------.--#
##-----#-#-###-#
#----#--$------#
#-#--#-------#-#
#------#-#-----#
##$-#----#---#-#
##-----------#-#
################