################
##--#-##---#-#-#
#--------------#
###--#---#-###-#
##-.-#-#-#-----#
#------.-#--#-##
#----#---#-----#
##-#-#--##---#-#
#----#---#-#---#
#-----#$$-#--#-#
#--#---------#-#
################