################
#-#-######-#---#
#------#-------#
#-###--#--$----#
#--------------#
##---#-#-#--#--#
#------#-#-----#
##-###-#-#---#-#
#-----.--$-----#
##-#--###.-----#
##-#-----------#
################