################
#----#---#----##
##-------$-----#
#-----##----#--#
#--------------#
#----#-###.#-#.#
#----#-----#---#
#----##------#-#
##-----#-------#
##--##-##-$-##-#
#----#---------#
################