################
##---###--#-#-##
#--------------#
#----#---#--#--#
#--#-#--.------#
#--------#---#-#
#--#-#-----#.--#
##----#----#-$-#
##-------#-----#
##-#-$--##-#-#-#
#------------#-#
################