################
##-###-#-##----#
#--------$-----#
#--#--------$#-#
##-#-----#---#-#
#--------------#
#--#-----------#
##--------##-#-#
##---#-#-.-----#
##--##.--#--##-#
#------#-------#
################