################
#-##-###--##-###
#--.--.--------#
##--##------#$-#
##---#---------#
####-##--#--##-#
#----#-------$-#
##---#---#-###-#
##-----#-------#
#--#-#-#-####--#
##-------#-----#
################