################
##-##--###--##-#
##-------------#
##-#-----###-#-#
##---------$---#
#--#.###---#-$-#
#--#---#-#-----#
##-##----#-#-#-#
#------------#-#
#----------#-#-#
#----.-------#-#
################