################
###---#--#-#-###
##-#-#---------#
#----------#---#
##-----------#-#
#-----#-----#--#
#--------------#
##---#--##-#-###
##---#-#---#-$-#
##-----#-###-$-#
#--.----.------#
################