################
##-----##-###-##
#--#-.---------#
##-###-$###$#--#
#----#.--------#
##-#---##--#---#
#----#-#-------#
##-#-#-----#---#
##-----#-#-----#
#--#-----#-#####
#--------------#
################