################
#--#-#-##----#-#
##-------#-----#
######---#---#-#
##-#-----#-----#
#----#-##-.#--.#
#--------------#
##----##----#--#
##--------$--#-#
##-##-$--#---#-#
#--------------#
################