################
#####--#-##-#--#
#--#-----------#
#------#-####--#
#----#-#-#-----#
#--#-#-#-#-$#--#
#----#---#.----#
##--#--#-#-#---#
#--$---------#.#
##--##-#-#---#-#
#--------------#
################