################
#--#---#-#####-#
#--------------#
#----#####-##--#
#----#-----#---#
##-#-#$#--#--###
#--#-----------#
#--#-###--###--#
##-#-----#-----#
##-#-------#$#-#
##-.--.--------#
################