################
##-#-#-#--##--##
#--#---#--$----#
##-------##$#--#
#----#-.-------#
##--##-----#-#-#
#----#---------#
##---.--####---#
##-#-------#---#
#-----#--#--#--#
#--------#-----#
################