################
###----####-#--#
#------#-------#
#--#-#-#-#-----#
#------#-------#
#-##-#---#-###-#
#------#-----#-#
##$-#----------#
#------#-----#-#
#------#-##-.$-#
#-------.------#
################