################
###--##---#-#-##
##-------#--.--#
#--#-##--#-#-#-#
##---#-#-------#
#--#-#-#-#-$.#-#
#------#-------#
#--##--#-$-#-#-#
#------#---#---#
##-#----##---#-#
#--------------#
################