################
#-#######-#--###
#--------------#
###-##-$-#--#--#
#--------------#
###-##-##--###-#
#--------------#
#---#-###----#-#
##$#---------#-#
#--#-##--#-#-#-#
#---.----.-----#
################