################
#--###-#--##---#
#---.--------#-#
###----#-#-#-#-#
#----#-----#---#
##-----.##-###-#
#----#---------#
#--#------#-$-##
##-#-----#-----#
#-$---##-#--##-#
##-------------#
################