################
###-###-#-#--###
##-------------#
##-#.-##-#-#-#-#
##------.----#-#
#--#------#$#--#
#----#-#-------#
#--##------#$-##
#--#---#---#---#
#----#---#####-#
##-------------#
################