################
####---#-#--#-##
##------$------#
###--##----#---#
##---#---#.--#-#
##-#-#----$#-#-#
#--#-------#---#
#--#-#-##-#--###
##---------.---#
##---#-#-#-#---#
##-------------#
################