################
####-------##-##
##------.------#
###-#--#---#---#
#--------------#
##-####----##--#
#--------#.----#
#------###-$####
#--#---#-------#
##-#-#-#-#-##$-#
##-------#-----#
################