################
#---##------##-#
#--#-$---#---#-#
##.-$--#-#-----#
#--#-------#---#
##---#-#--#----#
#--#-----#-----#
#----#-#-#-----#
#--#-------#---#
#-.----#-#-#-#-#
#----#---------#
################