################
###----####-.--#
#----------#---#
#--#--#-#--#--.#
##-------------#
##-##-$##--#---#
#--#---------#-#
##-$--#----#-#-#
##-------------#
#--###-##-#-##-#
#--------------#
################