################
##--##--#----#-#
#--------.-----#
##---#-#-#-#---#
#----#---------#
#-##-#-#---#---#
#------.-----#-#
##-$#--#-#-----#
#----#-----#-$-#
####-#--#-##---#
##-----------#-#
################