################
#--#-#----##---#
#--------#-----#
##--##-#-#-#---#
##-----#-#-#---#
#-####-#--#--#-#
#------#-----#-#
#------##-###--#
#-----.-----$--#
##$---##-#-.---#
##-------------#
################