################
##--#-#-#----#-#
#--------------#
#-###--#-----###
#------#-#-----#
##-$$##----#---#
#--------------#
##-###-----#---#
#------------#-#
#---#--###.-##-#
##----------.--#
################