################
#-##--###--#####
#-.----.-------#
##---#----#$##-#
#--------#---#-#
##--#-#--$-#-#-#
#------#-------#
#--#---#####-#-#
#--------------#
####-####--#-#-#
##-------------#
################