################
#-#-###--#-----#
#------#-------#
#--###-$-#---###
##$#---#-------#
##-#--##--##-#-#
#-----------.--#
#--#----#---##.#
#--#---------#-#
#----#-##----#-#
##-------------#
################