################
##---##---#----#
##-------------#
##-#---#----.###
#----#--$-.#---#
#----###-#--#--#
#--#-----#-----#
##-#-#-##-#--#-#
#--#--$--------#
##------##-#-#-#
##---------#---#
################