################
#-#----#--#-#--#
#-------.------#
#---###$#--##$-#
##-------#-----#
#-#-##.--#-#-#-#
#------#-----#-#
##--#-#-#--#---#
#----------#---#
#--#--#---#--#-#
#--------------#
################