################
##----##---##-##
##-#-----------#
#---##-------#-#
##$----------#-#
#--#-#--##---#-#
#----------#-#-#
#----#-#-#--$--#
##---#-------#-#
##-#-#---##--#.#
##--------.----#
################