################
#-##-#---#----##
#--------------#
##-###-------#-#
##--.--#---#---#
#------#---#---#
#--------#-$-#-#
#---#-##-#-##--#
#--#-----------#
#---.----#-$--##
##---#---------#
################