################
##-###-#---#--##
#----------$---#
#-##--$#-##----#
#----------#---#
##-#--##-###---#
#------------#-#
##-#-#######-#-#
#----#---------#
#--#.-##---#-#-#
#------.-------#
################