################
#---####--###--#
#--------------#
######--##-#-#-#
#----------#$$-#
#-----#--#---#-#
#--------------#
#--#-#---------#
##---#-.-#---#-#
#-##.--#-#-----#
#----#-----#---#
################