################
####-#----#--#-#
#-.-----.------#
#-----##-----#-#
#------#-----#-#
#--#-----##--#-#
#-----------$--#
##---##-#-----##
##-#-------#---#
#---####$#--##-#
#--------------#
################