################
##-##-##------##
#--------------#
#--#-#-#--$#-#-#
##-$-#-----#---#
##-#----##-#-#-#
#--------------#
##--.--#-.--##-#
#--------------#
#---#----###---#
##-----------#-#
################