################
#-##-#-#####---#
#----------#---#
##--##-----#-#-#
##-----#.--#---#
#--##--------#-#
#-----$#-------#
##--#----#--$--#
#--#--.--#-#---#
##-#-#---#-#-#-#
##-----#-------#
################