################
##--###-######-#
#----#---------#
####---###-----#
#--------#-#---#
#-$#---#$#----##
#--#-------.-#-#
#---#---#-#----#
##-#-------#-#-#
##-#-#-#---#-#-#
#----#---#---.-#
################