################
###----#-#######
##----$-$.-----#
##---#------##-#
##-----#-------#
###-##-#-----###
#----#---------#
##---#--#--###-#
##-#-----.---#-#
#--#--##-#---#-#
#--------------#
################