################
##-###---###---#
#--------------#
#--#---#-###-#-#
##---#-#--.----#
#-------#---.#-#
#--#-#-----#-#-#
#--##--#---#-$-#
#----#---------#
##-#-##$#--###-#
#--#-----------#
################