################
####-#--######-#
#---$----------#
#----#-#-#--#--#
##---------$---#
#------#-#---#-#
#--#---#-.-----#
#--#---#-#-##--#
##---------#---#
##-------#.#---#
#--------------#
################