################
##--#------#---#
#------#-----#-#
#----#---#---#-#
##---#---------#
###--##-##---#-#
#--------------#
##---#-#-#-##$-#
##-#-----.-----#
##-#-$-###---#.#
##---#---------#
################