################
##-#####---##--#
#--------------#
##-#-#-###-#-#-#
#--#-----#-#-#-#
#----#---###--##
#--#---------$-#
##-#-#-#-#$#---#
##-#-#---------#
#----#.---#--#-#
#-.------#-----#
################