################
##---##-.--##-##
#--------------#
#--#####---#-#-#
#----.-------#-#
####-##--------#
#----#---#-----#
#--#-#-###---#-#
##-------#--$--#
#----------#-$-#
#--------------#
################