################
##---#-##-----##
#--------------#
##---#-###-###-#
##-----------#-#
#--#-----##--$-#
#--------------#
#-#-##-#-####--#
#--------------#
##-$-#-#-###-#-#
##-.--.--------#
################