################
#-##-##---###--#
#--#-.---------#
##--##---##--#-#
##-----.-------#
##-#---#-#----##
#------#--$#-#-#
##-#-#-#---#-#-#
#--#-----#-#-$-#
#------#---#-#-#
##-------#-----#
################