################
##----#-#-##---#
##---------.---#
#---##-###-#-#-#
#----#---#-----#
####-##--#-$.#-#
#------#-------#
##---------#-#-#
#--#-----#-#-#-#
#-----##---$-#-#
#--------#-#---#
################