################
#-###-#--#-###-#
#--------------#
#---#---#---##-#
#----#-#-------#
#--#-#-#--##-#-#
#----.-----#-$-#
##-###---#-$-#-#
##-----#-------#
#------.---#-#-#
##---------#---#
################