################
#--#---#---##--#
#----#---------#
####---#-----#-#
##-----#-$-#---#
#--#--##-#-##--#
#-----$--------#
#---.----#-##--#
#-----.--------#
##-#----#-#-##-#
#--------------#
################