################
##--#--#-###-#-#
##.------#-----#
#-----.#-#-###-#
#------#---#---#
#---#$-#####-#-#
#--#---------#-#
#--#-####------#
##---------$---#
#--#--#--#-#-#-#
#--------------#
################