################
##----###-#--#-#
##--.#---------#
#-------.-###--#
#--#---#-------#
#----#-$-#---#-#
#------#-----#-#
##--##-------#-#
##-#-----#-----#
##-$--####--##-#
#----#---------#
################