################
##-----#########
##---#-----#---#
##---#---#-#-$-#
##-----#-----#-#
#--#-#---#-----#
#--#---#---#---#
#--#-#-###-#---#
#------#-------#
##-$-###-#-#---#
##-----.--.----#
################