################
##-########----#
##-----#-------#
##-###-#---##--#
##-------$-#---#
#--##-##--#--#-#
#----------#-#-#
#--------#-#-#-#
#----#---#-----#
##-##-##----#$-#
#-.--.---------#
################