################
##----###-#-####
#--------------#
###-##-----##--#
##-------------#
##-#---###-#---#
#-$--#---------#
#---#--#-###--##
#----------#-$-#
#--#-----#.---.#
#----#---#-----#
################