################
######-##-#--###
##-#-----------#
#------#.###---#
##---#---#-----#
#-#--#------##-#
#--------.-#---#
#--###-#---#-#-#
##$$-#-----#---#
#--#-##--###---#
##-------#-----#
################