################
#-##-#----#-#--#
#--------------#
##--######---#-#
##-#----.--.$--#
##----#------#-#
#------------#-#
#---#------#---#
#--#-#---------#
#--#-$-----#-###
##-------#-----#
################