################
###----#-#-###-#
#--------------#
#---###--##--#-#
#------#-#-----#
######---------#
#----#-#-$-#-#-#
##-#-#---#-#---#
##-----#-$-#---#
##-------#-#---#
##-.---.---#---#
################