################
#--####-#--#--##
#-----.--#-.---#
#--##----#--#--#
#-----$------#-#
##-#------#--#-#
#--#---#---#---#
##-------###-#-#
#-$------#---#-#
##-##----#-###-#
#----------#---#
################