################
#-#-#--##-#-#-##
#----------$---#
#--#---#-##-##-#
##-------------#
##------#$---###
#------#-.-----#
##--#-#----#---#
#----.---#-#---#
#----------#--##
##-----#-------#
################