################
#----###------##
##---#-#-$-----#
###--#---#--##-#
#--------#-----#
#-----#--##-.#-#
#--#----------.#
#---##---#-----#
##---------#---#
#--#-$-#-##---##
#--------------#
################