################
#-#-#-###----###
#--$-----------#
#------#-#---#-#
##---#-------#$#
#--##--#-###-#.#
#----#---------#
#--#-#---#---#-#
##-------#-#-#-#
#---#-#-##----.#
#--------------#
################