################
##-----####-#-##
##-------------#
##-##--#-----#-#
##-----#-------#
######-#----#--#
#----#$--#-----#
#--#-----#----##
#------#.--$-#-#
##-#-#.#--#--#-#
#--------------#
################