################
###---#---###-##
##-------------#
##-###--##-#-#-#
#--$---#---#---#
##--##-#-##----#
#---$--------#-#
##----#----#-#-#
#--.-#-----#---#
#----###-#---#-#
#---.----------#
################