################
#-#####--###--##
#----#---------#
#--#----#------#
#-$#-#------$.-#
#----###-#-----#
#--------#-#---#
#--#--------.#-#
##-----#-----#-#
#---#--#---#---#
#------------#-#
################