################
#######-####---#
##------.--#---#
#--##------#---#
##---.-#-#-----#
#-#--#-#-----###
#------#-------#
##-#-###-#---#-#
#--------#-----#
##-$-#$-##-###-#
#--------------#
################