################
###--##---######
#--#-----------#
##-#-##-----##-#
#--------------#
##-#--#----#.#-#
#-$--------#-#-#
##-#---#-----#-#
#--------#-$-#.#
#--#-----###---#
##-----#-------#
################