################
####--###-######
#--------------#
#--#--#---#-#--#
#--#-#-----#-$-#
##-#-#.--#-#--##
#--#-#--.------#
#--#---#-------#
#-$------#---#-#
#-##---#-#-----#
#--------------#
################