################
#--####--#-###-#
#----#-----#---#
##----##-#-#---#
##---#-----#-$-#
##-#-#-#------##
#---$-.#-#-----#
###--#-#---#-#-#
##-.-----------#
##---###-#-#-#-#
##-----------#-#
################