################
####-#####-#--##
#--.-#---------#
#----#-#.###---#
##-#-----#-#---#
##-###-#-$-#---#
#--------#---#-#
#--------###-#-#
##---#-#-----#-#
#--#-----$-#---#
#----#-----#---#
################