################
##-##--##----#-#
#--#--$--------#
##----##--#----#
##-------.---.-#
##---#-#--#--#-#
#--#-#-----#---#
#----#-#---#---#
#----------#-#-#
#--#-$-#-#-#-#-#
#--------------#
################