################
##--##--#-###--#
##-.-----.-----#
##--###---#--#-#
#--------#---#-#
##---###------##
#--------#-----#
#--######--#-#-#
##-------#-#-$-#
####--#--###$#-#
#--------------#
################