################
#---##----#---##
#--------------#
##---#----#--#-#
#--#-----#-----#
#--###-##--###-#
#----#--$------#
#-#---##------.#
##---#-$-#-#.--#
##-#---#-#---#-#
##-------------#
################