################
#-#--##----###-#
#------#-------#
##--#--###-$##-#
##---#-.-----.-#
##---##$-###-#-#
#------------#-#
##-#-#-###-----#
#------------#-#
##--##-------#-#
##-----#-------#
################