################
#------##----#-#
##-------#-.---#
#--##----------#
#------#-----#-#
#-##---#####---#
#-------$---.--#
##----##--#-#--#
##-------#-----#
#----#-##--$-#-#
##---------#---#
################