################
#--##-#------#-#
#----.-$-----#-#
#-#--##.###--#-#
##---------#-#-#
##---#-##--#---#
#----#---------#
##-#--##-#-#-#-#
##-#---$-#-#---#
#--#---#-----###
##-------#-----#
################