################
#-----#----#####
#--#-----.$-.--#
#--#-#---#-#-###
##-#-----#-----#
##-------#-###-#
#-$----#-#-----#
##-##--##--#-#-#
##---------#---#
#--##----#-#---#
##-------------#
################