################
#########-#-#--#
#--#-------$---#
#----#--###-#--#
##---#---------#
####-#-----#####
#----#-----#---#
##------#------#
##-#.$-#-------#
##-#-###-------#
#-----.--------#
################