################
###-####--##-#-#
##------.--.---#
#--#-#-##-$----#
#----#---#-----#
##-#-----#####-#
#----#---------#
##--#---##---###
#--#---#---#---#
#--$-#-----##--#
##-------#-----#
################