################
#--#-----###-#-#
#------#--.----#
##-------#--.--#
##-----#-#-#---#
#--##--##------#
#--#--------$--#
#--#-#-#-##----#
##-----#-------#
#--#---#-#$-#--#
#--------#-----#
################