################
##-##-##--#-#-##
##-#-----------#
#-.-###---#----#
##--.--------#-#
##-#$#-####----#
#------------#-#
#--#####-#$#-#-#
#--#---------#-#
##-#-#----#-##-#
##-------------#
################