################
##---#-###---###
#--#-----------#
##-###-#-#--#-##
##-----#-$-#---#
#--------##--#-#
#----.--$----#-#
##--##-###-#---#
##---#-.-------#
####-#-#-#-#---#
##-----------#-#
################