################
#-------#-####-#
#-$--#---------#
###------#-#---#
##-------#-#-#-#
##---#--##-#-#-#
#--#-------#---#
##---#-#-#---#-#
#------#-$.#---#
#----#---#--##-#
#--------.-----#
################