################
#---##--##--##-#
#----.---.-----#
#####----#-#-$-#
##---------#---#
#--#-##-#----#-#
#----------#-$-#
##-#-#-#-##--###
##-#-----#---#-#
#--#-##-#---#--#
##-#-----------#
################