################
#-------###-##-#
#----------$$.-#
#---##-#-#---#-#
##-----------#-#
###--#---##-##-#
#--#---#-------#
#-----------#.-#
#----#-#-#-----#
##---#-#-------#
##---#---------#
################