################
##-##--#-###---#
##-------------#
##-###-#-###-$-#
#----#-----#---#
####-#-#-------#
#----#-#-#-----#
##--#-$---.-#--#
#--------------#
##-####---###.-#
##-------------#
################