################
#######----##-##
#--------------#
##-$-#-----#--##
#--#-$-#-------#
#----#----###--#
#------.-#-----#
##----#-##-#-#-#
#--#---#-----#-#
#--#----.#---#-#
##-------#-----#
################