################
#---##----###--#
##-------------#
#----#-#-####--#
#----#-------#-#
##---#-----#-#-#
#------#---#---#
##--.--#-$#-#--#
#-----$#-------#
###----.-#---#-#
##-------#-----#
################