################
#------#####-#-#
##-------.-----#
#--#-###--#---.#
##-#-----------#
##-#-#$$-#---#-#
#----#---#-----#
#--##-####---#-#
#----------#---#
#--##--#---#---#
#--------------#
################