################
#--####-####---#
##-----------#-#
#----##-#--#---#
#----#---#--$--#
#-#--#---#-----#
#----------.---#
##--##-------#-#
#-$----#---#---#
##---#-------#-#
##-----------.-#
################