################
##-########-####
#------------#-#
##-#-###-------#
##---------#-$-#
#---#-##---##--#
#----.--.#-----#
##--##-#-##----#
#--------$-----#
#----#-###--##-#
##---#---------#
################