################
#-#-###-#--#---#
#----#-------#-#
##-#-#-##--#---#
##-$-#---#-#---#
#--#-----#-##--#
#--------#-----#
##-$#-#----#---#
##-----#-------#
##-#---.----.--#
#--------------#
################