################
###--###----##-#
##-#-----#-----#
#--#-#-----###-#
#------#-------#
##-##-##.#-#---#
#-----.----$-#-#
##-#-##----###-#
#------#--$--#-#
##-#-#---#-#-#-#
##-----#-------#
################