################
#----#-#--#-#-##
#------------$-#
#---##---------#
#--------#-----#
##-#---------#-#
#---$--#-----#-#
#---.-#---##-#-#
##-------#---#-#
##---#--.###-#-#
##-----------#-#
################