################
#--#-#-#----####
##-------------#
#--#---##--##--#
##---------#-$-#
#--#-#-$-------#
#------#-#-----#
#-#-##-#-#-#-#-#
##---#--.----#-#
#-----##-------#
#--#--------.--#
################