################
###-#----#---###
##---#-#-------#
#--------#-#---#
##-#-#---#---#.#
##-------#---#-#
#--#$#---------#
##-$-#######-#-#
##----------.#-#
##-##--##------#
#--------------#
################