################
################
####-------#####
####.#-###-#####
#--#--$--.-#####
##-#-###########
#--*----########
##-#-#-#########
#----$-#########
####-#-#########
###-----########
################