################
################
##-----#########
##-#-#-#########
##---#-----#####
##-#######$#####
#----#####--####
##-#$#####-#####
#--#-----#.#####
####.#-#-#-#####
###----#---#####
################