################
################
##---.-----#####
##-#-###########
##-$-#-#########
##-###-#########
#--#---#-----###
##-#-#-#-#-#-###
##-*-$---.---###
##-#-###########
##---###########
################