################
################
##-------.-#####
##-###-#-#-#####
##--##-.--$--###
##-###-#-#-#####
#--*---$---#####
##-###-#-#######
##-###-----#####
################
################
################