################
################
##-----$-#######
####-#*#-#######
##-------#######
##-#-#-#-#######
#-----$--#######
##-#-#-#########
##.-.----#######
##-#-###-#######
##-----#---#####
################