################
################
##---#######-###
##-#-#######-###
#--.-.-$------##
##-#-#-#-#-#-###
#------------###
######-#-#$#####
######-----#####
################
################
################