################
################
####-----#######
####-#.#-#######
####-------#####
######.#-#######
#--#-----$-#####
##-###$###-#####
##-###-----#####
##-#####-#######
##---------#####
################