################
################
##---#-#########
##-#-#-#########
##---.----######
##-#-#-#-#######
#------#---#####
##-#-#-#########
#------$-*-#####
######-###-#####
######--$.-#####
################