################
################
##########-#####
##########-#####
#########--#####
##########.#####
#-$------------#
####-###-#-#-###
##-$----.----###
##-#-#-#####-###
##-----------###
################