################
################
##--.-.-########
##-#$#-#########
##-------#######
####-###########
#-----*--#######
####-#-#$#######
##-#---#--######
##-#####-#######
##-------#######
################