################
################
##-$------.-####
##-#####-#-#####
##--.---*--#####
##$#-###-#-#####
#------#-#-#####
##-#-#-#-#######
##---#---#######
################
################
################