################
################
##-----#########
##-#-#-#########
#-----.-########
##-#-###########
#--------#-#####
##-#.#-#-#-#####
##-$-----$-#####
####-#-#-#-#####
####--------####
################