################
################
######----######
########.#######
##-#####-#######
##-#####$#######
#--#####-----###
##-#######-#-###
##-----.----$--#
##-#-#-#-#-#-#-#
##-------------#
################