################
################
#----#---#######
##-#-###-#######
##------.#######
##-#-###-#######
#---$--------###
##-#-#-#########
#--.$--#########
##-#-###########
#----###########
################