################
################
##-----###---###
##-#-#-###-#####
#----#-###-#####
##-#-#-###.#####
#--#-#-###-#####
######-###$#####
######-----#####
########-#######
########-$-.-###
################