################
################
####-------#####
####-#$#-#######
#-.----$-#######
##-#-###-#######
#------.-#######
##-#-#-#########
##-----#########
####-#-#########
####-------#####
################