################
################
########-----.-#
########-###$#-#
####-----------#
####-#####-###-#
#-----####-----#
##$###########-#
##.#########---#
##-#########-###
##-######----###
################