################
################
####-$---.---###
####-#######-###
####---#####-###
######-#####-###
#------###----##
##-#-#-#########
##-#$#-#########
##-#-#-#########
##-.---#########
################