################
################
##-#############
##-#############
##---###########
##-#-###########
#-----.--#-#####
####-#-###-#####
##------$--#####
####-#-#$#-#####
##----.----#####
################