################
################
#------------###
##-#-#-###-#-###
##-$-$-###---###
##-#-#-#########
#------#########
####-#.#########
####---#########
####-#-#########
##-----.-#######
################