################
################
#-$.---#########
####-#-#########
##-----#########
##-###-#########
#---------######
##-#-#-#-#######
#-.*-----#######
##-#$#-#########
#--------#######
################