################
################
##--$----.-*-###
##.#-#-#-#-#-###
##-$---#-----###
##-#-#-###-#####
#--#---##--#####
##########-#####
######-----#####
################
################
################