################
################
########-#######
########-#######
##---###---#####
##-#-###-#-#####
#-$--#-$-----###
##-#-#-#.#-#-###
##--------.--###
########-#-#####
######------####
################