################
################
########-$-.-###
########-###-###
########-#-----#
########-#######
#----###---#####
####-###-#-#####
####-----------#
####-#$#-###-###
####---.-##--###
################