################
################
#--#############
##-#############
#------#-#######
##-###-#.#######
#-$------#######
##-###-#-#######
##-------#######
##-#-#-#-#######
##--$.-----#####
################