################
################
##########---###
##########-#-###
##########-----#
##########-#-#-#
#---######-----#
##-#########-#-#
##-------###-$-#
##-#-#$#####-#.#
#--#--.--------#
################