################
################
################
################
##---###########
##-#-###########
#--$---------###
##-#-#-#-#$#-###
##-------.---###
##-#-#-#-#######
#---.----#######
################