################
################
################
################
####---#########
####-#-#########
#--#-------###-#
##-###-#-#-###-#
##---.----$--#.#
####-#-#-#-#-#$#
###------------#
################