################
################
###------.-#####
####-#$#-#######
####--$--#######
####-###-#######
#-----##-#######
##-#-###-#######
##---#---#######
##-#.#-#-#######
##-----#--######
################