################
################
######----.----#
######-###$#-#-#
##-----###-----#
##-#-#-#####.#-#
#------####-$--#
############-#-#
############---#
############-#-#
############---#
################