################
################
######-----#####
######-#-#######
######---#######
########-#######
#--*---.-#--$--#
######-#-#-#-#-#
######-.--$----#
########-#-#-#-#
########-------#
################