################
################
##---###########
##-#############
##---#-###-#####
##-#-#-###-#####
#---.------#####
##-#-#-#-#-#####
##-$----$--#####
##-#-#-#-#######
#---.----#######
################