################
################
######-------###
######-###-#-###
##------##-$-###
##-###-###-#-###
#--#---.------##
####-#-#########
##-$.--#########
##-#-###########
#-----##########
################