################
################
#---.----#######
##-#-#$#-#######
##------.--#####
##-###*#-#######
#------#--######
##-#-###########
##---###########
##$#-###########
##---###########
################