################
################
#------------###
##-#-###$#-#-###
##---.-.---#-###
##-#-###$###-###
#--------###-###
##-#-#######-###
##---###-----###
################
################
################