################
################
##-.*----#######
##.#-#-#$#######
#------$---#####
##-#-#-#########
#------#########
##-#-#-#########
##-------#######
################
################
################