################
################
#--------#######
##.#-#-#-#######
##--$-*--#######
##-#-#-#-#######
#--------#######
##-###-#########
##---$-#########
##-#-###########
#---.--#########
################