################
################
##---###########
##-#-###########
##--.----$-#####
##-#-#-#$#-#####
#----------#####
##-#-#-#########
##--------######
##-#-#-#########
##---.-#########
################