################
################
####-#--########
####-#-#########
##----.-########
##-#-#-#########
#----.---###-###
##-#-###-###-###
##---$-*-------#
##-###$#-#######
#----#-#-#######
################