################
################
##----$*-#######
##-#-#.#-#######
#--------#######
##-#-#-#-#######
#-----$---######
##-#-###########
##----##########
##-#-###########
##---.-#########
################