################
################
################
################
##--############
##-#############
#--#####-----###
##-#####-###$###
##-.-----------#
####-#-#-#-#$#-#
###---------.--#
################