################
################
########---#####
########.#-#####
##-###-$---#####
##-###-#-#-#####
#--------#-#####
##-#-#-#########
#---$--#########
##.#-#-#########
#--------#######
################