################
################
##-----#########
##-#-###########
##----$-########
####-#-#########
#-.---$--#######
##-#-#-#-#######
##-#--*---.-####
######-#-#-#####
######-------###
################