################
################
##-.-------#####
##-#-#$#-#-#####
#--*---------###
##$#-#####-#####
#----#####.--###
##########-#####
#######--------#
################
################
################