################
################
##-.-###-#######
##-#-###-#######
##---###-#######
##-#-###-#######
#-$------#######
##-#-###-#######
#-----*--#######
##-#-#-#########
##-.$--#########
################