################
################
########---#####
########-#-#####
##-###--$--#####
##-###-#-#-#####
#-------$#-#####
######-#-#-#####
###--.-.-----###
############-###
############---#
################