################
################
################
################
##-----#########
##-###-#########
#--###---#######
##-###-#-#######
#--------$*----#
##$#-#-#.#-#-#-#
#---------.----#
################