################
################
##------.------#
##-#-###$###-###
##--.--#-----###
##-#-#-#########
#-$--#-#########
##-#-#-#########
##---#-#########
####-#-#########
####---#########
################