################
################
################
################
################
################
#----###-------#
##-#####-#.#-#-#
#---$.$------#-#
##-#-#-#-#-#####
##---------#####
################