################
################
####---.----####
####-#$#-#-#####
##-----#-----###
##-#-###-#-#-###
#--#-##--#---###
####-###-#-#-###
####-.$--#-#-###
####-###########
##---###########
################