################
################
##-----#####-###
##-###-#####-###
#--.--.#####--##
##-#$#-#####-###
#-$------###-###
######-#-###-###
######-------###
########-#######
########-#######
################