################
################
######-------###
######-#$#-#-###
##-----#-.---*-#
##-#####-###-#-#
#-$--------#---#
##.#-#######-###
#----#######-###
##-#############
##-#############
################