################
################
#---.--#########
##-#-###########
##---##----#####
##-#-###-#######
#-$------#######
##-#-#$#########
##--.----#######
##-#-#-#-#######
##-------#######
################