################
################
##-----#########
##-#-#-#########
##---$-#########
##-#-###########
#----###########
##-#-###########
#---.-.--#######
##-#-#$#-#######
##-------#######
################