################
################
#--#######-#####
##-#######-#####
##--.-##---#####
##-#-###-#-#####
#--#-------#####
####-#.#-#######
##----$-$--#####
####-#-#-#-#####
####--------####
################