################
################
##-----------#-#
##-#-#-#-#-#-#-#
##------$-$----#
##-#-#-#-#.#-###
#------.-----###
####-###########
####-###########
################
################
################