################
################
##-###-$--.--###
##-###-###-#-###
#-.#-----#-#-###
##-#-#-#-#-#-###
#------#-#---###
##-#$###-#-#####
##----##---#####
################
################
################