################
################
#--#############
##-#############
#------.-#######
##-###-#-#######
#-$------#######
##-###-#-#######
#---$.-------###
####-#-#-#-#####
####-----------#
################