################
################
##########-#####
##########-#####
#######------###
########-#-#-###
#---------$-$--#
########.#-#.#-#
######---------#
######-#-#-#-#-#
######-#-----#-#
################