################
################
##---#----######
##-#-#-#-#######
#-$--#-#-----###
##-###-#.#-#####
#---*----#---###
##-###-#-###-###
##--##-$.----###
################
################
################