################
################
##-#############
##-#############
##---###########
##-#-###########
#-*$------######
##-#-###-#######
#-$--.---#######
##-#-#-#-#######
#------.---#####
################