################
################
##----.-.------#
##-#-#$#-#####-#
#-----------##-#
##-#-#####-###-#
#-$----###-###-#
##-#-#####-#####
##---#####-#####
################
################
################