################
################
##---*$--#######
##-###-#-#######
##-.------######
##-###-#$#######
#---##--.----###
##-###-#########
##-###---#######
######-#-#######
#####----#######
################