################
################
########-----###
########-###-###
##-----#-------#
##-#.#$#-#-#-#-#
#-$---.----#---#
##-#-#-#########
##-----#########
##-#-###########
##---###########
################