################
################
##---.---------#
##.#-#-#####$#-#
##-------###---#
##-###########-#
#-$--#########-#
##-#-#########-#
##-#-#########-#
##-#-###########
##---###########
################