################
################
#------#########
##-#.#$#########
##---#--########
##$#-#-#########
#---*--#-#######
####-#-#-#######
##-.-------#####
####-#-#-#######
####-----#######
################