################
################
##-------#######
##-#-#-#-#######
#--.--*$--.-$--#
##-#-#########-#
#----####--#---#
##########-#-#-#
##########-----#
############-###
############-###
################