################
################
################
################
####---#########
####-#-#########
#------.-#---###
##-#-#-#-#-#-###
##-$----.----###
##-#-#-#-#$#####
##-#-#-------###
################