################
################
##---.-#########
##-#-#-#########
##-$----$--#####
##-#-#*#########
#--------#######
##-#-#-#########
#--------#######
##-#-#.#########
##-----#########
################