################
################
#--------#######
##-#-#-#-#######
##-#-----#######
##-###-#-#######
#--.---#-#######
##-#-#$#$#######
##-*-----#######
##-#-#.#########
##-#---#########
################