################
################
#######----#####
########-#-#####
###--------#####
######-#-#-#####
#----#.#-#-#####
####$#-###-#####
##-----###.#####
##-#-#-###$#####
##---------#####
################