################
################
##########-----#
############-#-#
############---#
############-#-#
#-$------------#
########-#-#-#-#
########---$.--#
########-#-#-#.#
########-------#
################