################
################
##---###########
##-#############
##$----#########
##-#-#-#########
#-*----#########
##.#-#-#########
##-------.-#####
##-#-#-#$#-#####
##---------#####
################