################
################
##########----##
##########-#-###
########---#-###
########-#######
#--#-------#####
##-#$#-###-#####
##.-----.---####
##-#$#-#-#######
##-------#######
################