################
################
################
################
##########---.-#
##########-#-#-#
#----$-$-----*-#
######-###.###-#
######---------#
########-#-#-###
########------##
################