################
################
##----------####
##-#-#.###-#####
##----$----#####
##-###-#########
#--#-----#######
##-#-###-#######
##--.----#######
##-###$#-#######
##-###---#######
################