################
################
##-----#########
##-#-#-#########
##-.-----#######
##-#-#-#-#######
#-$------#######
##-#.#-#########
##------########
##-#-#$#########
##-----#########
################