################
################
#########--#####
##########-#####
########--$.-###
########-#-#####
#----###---#####
####$###.#-#####
##----------####
##-#-#-#-#######
#----------#####
################