################
################
##########---###
##########-#.###
##########-#-###
############$###
#--#########---#
##-###########-#
##-#-#-$----.--#
##-#-#-###-###-#
##-----###-----#
################