################
################
#------#########
##-#$###########
##-*-----#--.-##
##-#-#$#####-###
#------------###
##.#-###-#######
##---###-#######
################
################
################