################
################
#-------$.-.---#
##-#-#-#-#-#-#-#
##-#---$-------#
##-###-#######-#
#--###-#-###---#
########-###-###
########---*-###
################
################
################