################
################
####-----#######
####-#-#-#######
#--#-.-$-#######
##-#.#-#########
#-----$-########
##-#-#-#########
##-----#########
##-#-#-#########
##-----#########
################