################
################
##----##########
##-#-###########
##.-$-##########
##-#-###########
#----#---#######
##-#-#-#-#######
##-----#-#######
##-#-###-#######
##----$.---#####
################