################
################
##########-----#
##########$#-#-#
##########-----#
##########-#.#-#
#--.-$--*------#
############-#-#
########---#-#-#
########-#-#-###
#######--#---###
################