################
################
##-#-.-------###
##-#-#-#-#.#-###
##-$-----$---###
##-###-#-#-#####
#----#-----#####
##-#-###########
##----##########
################
################
################