################
################
################
################
##---###########
##-#-###########
#----###-#--####
##-#-###-#-#####
#---.-$.---#####
##$#-#-#-#-#####
##-------*--####
################