################
################
##----.--$-#####
##-#-#-#*#######
#--$---------###
##-#####-#-#-###
#-.#####---#---#
##-#######-#####
##-#######-#####
##########-#####
########---#####
################