################
################
#--.$--.-#######
####-#$#-#######
##-----#----####
####-###-#######
#----###----####
##-#-###-#-#####
#----##--#-#####
##-#####-#######
##---------#####
################