################
################
##-------#######
##-#-#-#-#######
##--$-$--#######
##-#.#-#########
#--------.-#####
##-#-#-#########
##-------#######
##-#-#-#-#######
##-------#######
################