################
################
################
################
##--############
##-#############
#----------#####
##-#$#-#-#-#####
##----$-.------#
##-###-#-#-#-#-#
##-----------.-#
################