################
################
##-----.-#######
##-#-#-#########
#------#########
##-#-#-#########
#-----$--#######
##-#-#-#-#######
#----.$--#######
##-#-#-#-#######
#---------######
################