################
################
####-.$--#####-#
####-###-#####-#
##-.-----------#
##-#-#####$###-#
#--#--##-------#
####-###########
###--###########
################
################
################