################
################
##-----#-------#
####-#$#-#-#-#-#
##-#-------#---#
##-#-###-#$###-#
#---.--#--.----#
################
################
################
################
################