################
################
##-----###--####
##-###-###-#####
##--##---------#
##-###-#-#-###-#
#--###----$-$.-#
######.#-#-###-#
######-----###-#
################
################
################