################
################
#---.------#####
##-#-#-###$#####
#--$-----.-#####
##-###-#########
#--#---#########
######-#########
##---*---#######
##-#-#-#-#######
##-------#######
################