################
################
##-------------#
##-#$#-###-###-#
##-------.-###-#
##-#.#-#-#####-#
#----$---#####-#
##-#-#-#########
##-----#########
################
################
################