################
################
##-------#######
##-#*#-#-#######
##$-------######
##-#$#-#.#######
#--------#######
##.#############
##-------#######
##-#-###########
##---###########
################