################
################
##-#############
##-#############
##---###-#######
##-#-###-#######
#----###-----###
##-#-###-###-###
##$-.--.*----###
##-#-#$#########
##-------#######
################