################
################
#---------######
##-#-#-#########
#--------#######
##-#-#-#########
#-$----#########
##-#.#-#########
##-----$-#######
##-#-#.#-#######
##-------#######
################