################
################
##--.-----######
##.#-###########
##-#$--#########
##-#-###########
#-$----#########
##-###-#########
##-#---#-----###
##-#-#-#-#-#####
#----#-----#####
################