################
################
##-----#########
##-#-###########
##------########
##-###-#########
#----#--########
##-#-#-#########
##-#--$-$----###
##-#-#.#-#-#####
#---------.--###
################