################
################
#---*--$-#######
##-#-#-#-#######
##---.-------###
##.###-###-#-###
#------###---###
##-#-#-#########
#--$---#########
####-#-#########
####---#########
################