################
################
#---.--#########
##-#$#-#########
##-#----#-.----#
##-###-###$#-###
#--###-#-----###
######-#-#######
##-------#######
################
################
################