################
################
########---#---#
##########-#-#-#
########-------#
########$#-#####
#--#####.----###
##-#####$#-#-###
##----.------###
##-#########-###
##----####---###
################