################
################
####-----.-----#
####-###-#-#$#-#
##---------#---#
##-#-#-#-#####-#
#--#-#---#-.---#
##########-#$#-#
##########-----#
################
################
################