################
################
##---#--.--#####
##-#-#-#-#-#####
#--#----$.-#####
##-#-#-#-#######
#-$------#######
##-#-#-#########
##------########
######-#########
######--########
################