################
################
################
################
#--#############
##$#############
#-*---.--#######
##-#-#-#########
##---$---------#
##-#-#-#-#-#-#-#
##-----.-------#
################