################
################
##-$-------.-###
##-###.###-#####
##---#-##--#####
##-#-#$#########
#----#---#######
##-#####-#######
##---###-#######
##-#####-#######
##-------#######
################