################
################
################
################
##-$---#-#######
##-#-#-#-#######
#----------#####
##-#-#-#.#######
#-.-$--*-#######
####-#-#-#######
##---#---#######
################