################
################
##----$----#####
##-#*#-#-#-#####
##-----$---#####
##.#-#-#-#######
#---.-------####
##-#-#-#-#######
##-------#######
################
################
################