################
################
##-----.---#####
##-#-#-###-#####
##---#-###-#####
##-#-#-#########
#-$-.$-#########
##-#-#-#########
#--------#######
##-#-###-#######
##-------#######
################