################
################
######-#---#####
######-#-#-#####
##-------#-#####
##-#-#####-#####
#---.---$--#####
##-#-###$#-#####
##-----.---#####
##-#-#####-#####
##----####-#####
################