################
################
###########----#
##############-#
#----####------#
##-#-#######-###
#----#######-###
####-#######-###
##---#####-----#
##-#######-#-#-#
##------.-$.$--#
################