################
################
##--*----#######
##-#-###$#######
#----------#####
##-#.###########
#----###########
##-#-###########
##--$--#-#######
##-#-###-#######
##---.---#######
################