################
################
################
################
#---##-----#####
##-###-###.#####
#----#-#---#####
##-#-#####-#####
##-$-$------####
##.#-###-#-#####
##---##-----####
################