################
################
################
################
##---###########
##-#-###########
#--$*---.---####
####-#-###-#####
##---#-###--$--#
##-#.#####-#-#-#
##----####-----#
################