################
################
##-------#######
##-#-###$#######
##---#--.--#####
##-#############
#---############
##-#############
##---$--.-######
##-###-#-#######
#--------#######
################