################
################
##------.$-$.--#
##-###-#####-#-#
##-###-####----#
##-###-#########
#--------#######
##-#-###-#######
##-------#######
##-#-#-#########
##-----#########
################