################
################
##---.-#########
##-#-#$#########
##--.----#######
##-#-###-#######
#-$----------###
##-#-###-#-#####
##---###-#-#####
##########-#####
########----####
################