################
################
######-----#####
######-#-#######
##----.---.--###
##-#-###-#-#-###
#----#---#$----#
########-#-#*#-#
########-------#
##########$#####
########---#####
################