################
################
################
################
################
################
#--#-*-#--$----#
##-#-#-#-#-#$#-#
#----------.---#
##-###-#-###-#-#
##-##--.-------#
################