################
################
###------#######
####-#-#-#######
##----$-$--#####
##-#.#-#-#-#####
#----.-----#####
##-#-#####-#####
#----#####---###
##-#############
#--#############
################