################
################
#-----.--#######
##-#-###########
#--$-###########
##-#-###########
#-.----#########
##-#-#-#########
#---*----#######
####-#-#$#######
###-------######
################