################
################
################
################
#---$--#########
##-#-#-#########
#--#-#---#-#####
####-#.#.#-#####
#-----*----#####
##-#-#$#-#######
##---#-----#####
################