################
################
#--------#######
##-#-#-#-#######
##-----#-#######
##-#-#-#-#######
#-.--#--$#######
##-#####-#######
##--$--.-#######
##-#-###*#######
##-------#######
################