################
################
################
################
##---#--########
##-#-#-#########
#-$----.-#---###
##-#-###-###-###
##---#-------###
##-###$#-#######
##------.----###
################