################
################
######--.------#
######-#####-#-#
##-----#####-$-#
##-#########$#-#
#--#######-----#
##########-#.#-#
##########-----#
############-#-#
###########----#
################