################
################
#----###########
##-#-###########
##-$---#--######
##-#-#-#-#######
#----.-#-#######
##-#####-#######
#----#---#######
##-###-#########
##-$.--#########
################