################
################
##---###########
####-###########
##-------.-#####
##-#-#####-#####
#---$------#####
##-#-###-#-#####
##--$------#####
##-#.#-#-#-#####
##-#---#---#####
################