################
################
##-------#######
##-#-###-#######
##-----$-#######
##-#-###########
#------#########
##-#-#$#########
##.--*-#########
##-###-#########
##--.--#########
################