################
################
##---###########
##-#-###########
#-.--$-#########
##$#-#-#########
#----*-#########
##-#-#-#########
##-------#######
##-#-#-#-#######
##----.-----####
################