################
################
########--.----#
##########-#-###
##########-#.-##
##########-#-###
#--#-#---#-#-###
##-#-#$#-#-#$###
##-----------###
##-#-###-#-#####
##---##----#####
################