################
################
##--$--------###
##-#-#-###-#-###
#-.---*----#-###
##-#-#-#########
#------#########
##-###$#########
##-----.-#######
##-###-#########
##-###-#########
################