################
################
######-#-----###
######-###-#####
####---.---#####
####-#-#$#-#####
#--*---#--$#####
####-#-#-#-#####
####-----.-#####
########-#######
########---#####
################