################
################
######---------#
######-#$#-#.#.#
######--$------#
##########-#-#-#
#--------------#
################
################
################
################
################