################
################
##--------.----#
##$#-#-#-###-#-#
##-----$-###---#
##-#-#-#########
#-*-.----#######
##-#-###-#######
##----##-#######
################
################
################