################
################
########-$-.---#
########-#-###-#
########-#-###-#
########-#####-#
#--#-##----#---#
##-#-###-#-#-#-#
##-$---------.-#
####-#########-#
####-#######---#
################