################
################
################
################
####-#######---#
####-#########-#
#----###-----.-#
##-#-###-#-#-###
#--------#---###
##-#*#-#$#-#-###
##--$-----.--###
################