################
################
########---#####
########-#-#####
######---.--####
######-#-#-#####
#---*--$-#-#####
######-#-#-#####
######--$----###
######-#-#-#####
######---#-.-###
################