################
################
################
################
##########-#####
##########-#####
#--#######-----#
##-#######-#$#-#
##-#----.------#
##-#-#$#-#-#-#-#
##-----.-------#
################