################
################
##-------------#
####.#.#$#-#-#-#
####-------#-#-#
####-#-#$#-#####
#------------###
####-###########
##---###########
################
################
################