################
################
################
################
######---#######
######-#$#######
#----#-$--.-####
####-#-#-#-#####
####---#-----###
####-###-###-###
####--.-------##
################