################
################
##-$-#####--####
##-#-#####-#####
##.--.-#---#####
##-#-#-#-#######
#--$*----#######
##-#-#-#########
#--#-----#######
##-###-#-#######
##-------#######
################