################
################
##-----------###
##-#-#-#-#-#####
##------.--#####
##-#-#-#########
#-$----#########
##-#-#-#########
##----$-########
######-#########
####--.--#######
################