################
################
#------#########
##-#-###########
#-------########
##$#-###########
#--#---#########
##-#.#-#########
##----.--#######
##$#-#*#-#######
##-------#######
################