################
################
################
################
######-#########
######-#########
#--#---###---###
##-###-###-#*###
#------.--$--###
##-#-#-#-#-#####
##---------.-$-#
################