################
################
##---------#####
##-#-#-#-#######
##---#------####
##$###-#$#######
#-.--*----######
####-#-#-#######
####---#-#######
####-#-#-#######
####-.----######
################