################
################
#--#############
##-#############
##-----.-------#
####$#-###-#-###
#-----$----.---#
##-#######-#-###
##*---####---###
##-#-###########
#----###########
################