################
################
####---#########
####-#-#########
##---#-#########
##-#-#$#########
#-----$-########
##-#-#-#########
#------.-----###
##-#-#-#-#-#####
##--.--#------##
################