################
################
################
################
##-----.-#######
####-#-#-#######
#----#-$$#######
####-#-#-#######
####-------###-#
####-#-#-#-###-#
####----.------#
################