################
################
################
################
##-######--#---#
##-#######-#-#-#
#----#-#---#-$.#
####-#-#-#-#-#-#
####-----#---#-#
######-#-#-###-#
####-----#--$.-#
################