################
################
#------.-#######
##-#-#-#-#######
#--------#######
##-#-###-#######
#------#.-######
##$#-#-#-#######
##*-$----#######
##-#-###########
#------#########
################