################
################
####---#########
####-#-#########
#--#$--*-#######
##$#-#-#-#######
#-.---------####
##-#.#-#########
##-----#########
##-#-###########
#--#-###########
################