################
################
################
################
########---#####
########-#-#####
#-----$--------#
##-#-###-#-###-#
##--$--.----##-#
##-#-#-#-#.#####
##-------#-#####
################