################
################
##---.-#--######
##-#-#-#-#######
##-------#######
##-#-#-#-#######
#-$*---$-----###
##-#.#######-###
##-#-#######-###
################
################
################