################
################
########---#####
########-#-#####
##---##-$------#
####.###-#-#####
#--#----.---####
##-#-#$#-#######
##-------#######
##-#-###########
##---###########
################