################
################
#-------.--#####
##-#-#-#-#-#####
#----------#####
##-#-#-#########
#---$--#########
##-#-###########
##--$###########
##-#.###########
##----##########
################