################
################
################
################
##-----#########
##-###-#########
#----#-#-----###
##-#-###-###-###
##-----$-#---###
##-#.#$#-#-#####
##----.----#####
################