################
################
##-----------###
##-#.#-#-#######
#-.--$---#######
##-#-#-#-#######
#------$-#######
##-###-#########
#--------#######
######-#-#######
######---#######
################