################
################
##--.-.--#######
####-#-#########
##---$-###-#####
####-#-###-#####
#-$----------###
####-#-#-#-#####
####-#-----#####
##########-#####
##########-#####
################