################
################
##---###########
##.#$###########
##-$-###---#####
##-#-###-#-#####
#----------#####
##-#-#-#-#-#####
#--#.---------##
##-#-#-#-#######
##---#---#######
################