################
################
###--------#####
####-#.#-#-#####
##----$-.----###
####-#-#-#-#-###
#----#$----#--##
######-#-#######
######---#######
########-#######
######---#######
################