################
################
####-------.---#
####-#-#-#$###-#
#----#---------#
##-#-#######-#-#
#--#-$.-####---#
############-###
############-###
################
################
################