################
####------#---##
#------#-------#
##----------#--#
##---#-#-------#
#----#--.-##---#
#----#---------#
#----------#-$-#
##-#-----------#
#------###---#-#
#--------------#
################