################
#--##-#----#---#
##-------------#
##-----##--##--#
##-----#-------#
#----#---##--#-#
#------------#-#
#--#----##-#---#
##---#----.#---#
##--$--#-#-##--#
##-------------#
################