################
#--#-###-#-----#
##-------------#
##-#-#-#---#-#-#
#--------#---#-#
#-##---------###
#------#-#-----#
##-#---#---#-$-#
#--#---#-------#
##---#-----#-#-#
##----.--------#
################