################
#----######-#--#
##---#---------#
#-#--##-----#--#
#----------#---#
#--##---#----#-#
#--#-------#-.-#
#----#--##-----#
##---------#---#
##-#-$-#-----#-#
##-----#-------#
################