################
#-#-----#####-##
#----#-------$-#
#-#--#-#-------#
#----------#---#
##--#--#---##--#
#------------#-#
#--#---##--#---#
#------.-------#
##---#-------#-#
##-------------#
################