################
#--##-##------##
##-------------#
#----#-------#-#
#--------#---#-#
#--#-#---#---#-#
#--#--------.--#
##-#-#-####----#
##-----#-------#
#---##-#-$-#-#-#
#--------------#
################