################
#-#--###--##---#
#--#-----------#
#--#-----#-#---#
#----.-----#---#
#--------#-----#
#--------#-----#
##-----##--##--#
##-#-------$---#
##-#-#-----#---#
#--------------#
################