################
#-##------##--##
#------------#-#
##-----#-##--#-#
#------#-------#
#------#-#--#--#
#------#-------#
#---#----##----#
##-----------#-#
#------#---##--#
#-.---------$--#
################