################
##---#---##-##-#
#--.-----------#
#----#-#-----#-#
##---------#-$-#
##--#----------#
#--#---------#-#
##----#--#-#---#
#--------#-----#
###--#-###-----#
#--------------#
################