################
##-----#--#-##-#
#----#---------#
#------#-----#-#
#----#---------#
##---#-#-#--#--#
#------------#-#
##-##-##-#---#-#
##------.--#-#-#
#--#$#-#-#-#---#
##-#-------#---#
################