################
#-----###-#-#--#
##----------$--#
##-------------#
##-#-#---#-#---#
##-##----#---#-#
#--------------#
#-------.----#-#
#----#---#-----#
#--#------###--#
#--------------#
################