################
#--#-#-----#--##
#--------------#
#-#-----#---#--#
#--------------#
##-#----###--#-#
#----------#---#
#--#-#-#-----$-#
##-#------.----#
##-------#-#---#
#------------#-#
################