################
#---##--##---###
#----#.--------#
#--------------#
#----#-#-------#
#--#--#------#-#
#------------#-#
#----##--#-#-#-#
#----#-----#-#-#
#--#-------#-$-#
##-------#-----#
################