################
###-#----#-#-#-#
#-----------$--#
#--#-#-#-----#-#
##-----#-------#
#--#-#-----#-#-#
#--------------#
###------#-#---#
#---.----------#
##-------------#
#--------------#
################