################
#-#--##--#-----#
#--------#-----#
##--#----#-----#
##-------#---#-#
#--------------#
#--#-----------#
##-#-#----##-.-#
#-$------#-----#
##--##---------#
#----------#---#
################