################
#-#-#--------#-#
#--------------#
##-#--#-##--#$-#
#--#-#---------#
##-#-#-#-------#
#--------------#
#-#----#---#---#
#------#-------#
#--#---.---#-#-#
#--------#-----#
################