################
##-#-#-----###-#
#--------------#
#--#--###------#
##---#---------#
#--#-#-#--##---#
#--------#-----#
#--##--#---#---#
#--------------#
##--#-----#$##-#
#---------.----#
################