################
##----####--#-##
#------#-------#
##----$--#-#-#-#
##-----#---#---#
##-#-###--#--#-#
#--------------#
##------#----#-#
##-----#---#---#
#--.#--------#-#
#--------------#
################