################
#---#-##-#----##
##-#-----------#
#--#---##--#---#
#------#---#---#
###----#-##--#-#
#---$----#---#-#
##---#-#-#---.-#
##-------------#
##-------#--##-#
##---#---------#
################