################
#---####----####
#------------.-#
#--#-#-##-##---#
##-------------#
##-##$#--------#
#----------#---#
#----#---#-#-#-#
##-#-#-----#---#
##-#---#-#-#-#-#
#------------#-#
################