################
#--#--#-------##
#--------------#
#--#-#--#--#-.-#
#--$---#-------#
#-#----#----#--#
#--------------#
##-------#--#--#
#----#---------#
#--#-#--##-#-#-#
#--------------#
################