################
#--#--#-#-----##
#--#---------.-#
##-------##--#-#
##-#---------#-#
#--#--#--------#
#--------------#
##-$-#-#---#---#
#----------#---#
#-##---#-###---#
##-----------#-#
################