################
###---##--#---##
##-#-----#-----#
#--##-#--------#
##-----#--.----#
#----#-#-#-----#
#--------------#
#------------#-#
##-------------#
#-$-##---------#
##---#---------#
################