################
#---#--#-#-----#
#---------.----#
#-##-------#-###
#--------------#
##$-###----#---#
#--------------#
###-------##---#
#--------------#
##--#------#-#-#
##-------------#
################