################
#-#--####----#-#
#----------#---#
#-$--##--#---#-#
##-------------#
#--#-------###-#
#--------#-----#
##-##---#------#
#------#-----#-#
#------#-##----#
#-------.--#---#
################