################
####-##--##-##-#
##-------------#
#--------##-##-#
#----#---------#
#----#-#-------#
#--#----.------#
#--#-----------#
#----#---------#
#----#-#---$---#
#--------------#
################