################
##--#-#--##--#-#
##-------------#
#--------#-----#
##---#-------#-#
##-###--##---#-#
#------------#-#
##---#----#-##-#
#--------------#
#-#--#-#--#-$#-#
#----.---------#
################