################
###-##---------#
#----#---------#
#--------##---##
#--------------#
##-----####--#-#
#--#-----------#
#-----#----#---#
#--#----------.#
#--#--$-#----#-#
#------#-------#
################