################
###--#----####-#
#----#---------#
##--------##-###
#--------------#
#---##-#-###---#
#----#---#-----#
#-#--#--##--$--#
#--------#----.#
#--##------#-#-#
#------#-------#
################