################
##--#-#--##----#
#--#--------$--#
#--#-.-#-#---#-#
#----------#-#-#
#-#-#--#-#-#-###
#----#---------#
#--##---#---#--#
#--------------#
#--#-#---------#
##-#-----------#
################