################
#---------####-#
#----#---------#
###------#-#---#
##-----------#-#
#----#--##-#-#-#
#--#-----------#
#----#-#-#-$-#-#
#----------#---#
#----#---#--##-#
#-------.------#
################