################
#---##--#----#-#
##-----------#-#
#----#-#-#-----#
#----------#---#
##$--###----##-#
#------------#-#
#-#------#-----#
#--------------#
#----#-#----#--#
#-----.--------#
################