################
##--#----##----#
#----#.----#---#
#----#---#---#-#
##-#-----#-----#
#----#------##-#
#------------#-#
#------#--#--$-#
#------#-----#-#
#--------#-----#
#------#-------#
################