################
#----------##--#
##-------------#
##-------------#
##---------#-#-#
#---#--#-#--##-#
#--------#---$-#
##------##---#-#
#--#-.---------#
#------#-#---#-#
##-------------#
################