################
#----###-###--##
##---#---------#
#-$-----###----#
##-----------#-#
#---------#-#--#
#--------#-----#
###--##----##--#
##-------------#
##----#.-#-#-#-#
#--------------#
################