################
#---##-#--#----#
##-#-----------#
##-#---#--##---#
##-----#-------#
##--#--#-#--##-#
#--------------#
##---##---#--#-#
#-----------.--#
##------####-$##
##-------------#
################