################
#--###--#----#-#
#--------------#
##-------------#
##-#-----#---#-#
##-#-#-#-##-#--#
#--------------#
##-------###---#
#----#-#------.#
##-#-#-##-$#-#-#
##-------------#
################