################
#--#-##-#---####
##-#-----------#
##---#-#-#-#$#-#
#----#---------#
#-##-#-#-#-##--#
#-------.------#
##-#-#----#--#-#
#--------------#
##-#---#---#---#
##-----#-------#
################