################
#--#---##--#-#-#
#-----------$--#
#--#####---#---#
##-----#-------#
##---#------#--#
#----#---#-----#
#----#--------##
##-------#-----#
#---------#-##-#
#-----.--------#
################