################
#-#----#--###--#
#------#.------#
#--#---#---#-#-#
##-#-------#-$-#
##-----------#-#
#--#---------#-#
##------#-#----#
#----#-------#-#
##-#-#----##-#-#
#--------------#
################