################
###---#-####--##
##--.--------$-#
#--------#-#---#
#--#-----------#
##---#--#-####-#
#----#---------#
##---#-----#---#
##-----#---#---#
##---##--#--#--#
##-------------#
################