################
##-##-#-###-#--#
#--#-----------#
#----#--#----#-#
#--#-#-----#---#
##-----#-------#
#------#-#-----#
###-#------#-#-#
##---------.---#
#-----##-#-#-$-#
##-----------#-#
################