################
##-##--#--#---##
#--------------#
#-##-----------#
#--#---#-------#
##-####----#---#
#------#-------#
#--##-$#--##---#
#--------#-----#
#--.--###--###-#
##-------------#
################