################
##---#--#--#--##
##----------$--#
#--#-----##--#-#
##-------------#
#---------.#---#
#------#-----#-#
#--#--#-#-#----#
#--------------#
#--###-#-#---#-#
#--------#-----#
################