################
###---##-#-#-#-#
#------#-------#
##-#-#--#--##--#
##-------#-----#
##--------#-$#-#
#--#----.------#
#--###-###--##-#
#--------------#
#-#-##---#-##--#
#--------#-----#
################