################
#----#-#---.-###
#--------------#
#------#---#---#
#------#-----#-#
#-------##---#-#
#----#---------#
##--##-##--#---#
##------$------#
##-##----#-----#
##-------------#
################