################
##--#----#-#--##
#--#------$----#
#----#-#---##--#
##-#---#-------#
#------#-----#-#
#----#-------.-#
#--#-#-#----##-#
#----#---------#
#---##----##-#-#
##-------------#
################