################
#-##-#--##-#---#
#--------------#
##-#--#----#-#-#
#------#.#-----#
#-#-##-#---#---#
#------#-----#-#
#--#--###-#----#
##-#---#-------#
##-#-#-----$-#-#
#--------#-----#
################