################
##----#--#----##
#--#---------#-#
##---#-------#-#
#------#---#---#
#--###--#---#--#
#----#-#-----#-#
#----#----#--$-#
#--------.-----#
#---###--###-#-#
#------------#-#
################