################
#-#-#---###--#-#
#-------$------#
#--#-##--##----#
##-----------#-#
###-####-------#
#--------------#
#-------#------#
#----.-#-------#
#---#--#-#---#-#
##-------#---#-#
################