################
##-----###--#--#
#--------------#
##$------##----#
#--#.--------#-#
#--------#-----#
#--#-----------#
##-#-#--##-----#
##---------#---#
###--#-------#-#
##-------------#
################