################
##-##--##-####-#
#-----.--------#
#--###--#----#-#
##---------#-#-#
###--#-#---#-#-#
#----#-----#-#-#
#------------#-#
#--#-------#---#
#----#----#-$--#
#----#---------#
################