################
#--##---##-##-##
#--------------#
##--.#-###-#---#
##-------#-----#
#------#$#--#-##
#--#-#-----#---#
#----#--##-#-#-#
#----#---------#
#----##----#---#
##-------------#
################