################
####-#--#-----##
#--#-----------#
#------#----#--#
#--------#-----#
##-#------#----#
#----#-------#-#
#----#-#-#-#---#
#------.-----#-#
#------##--$-#-#
##-------------#
################