################
##-#-----------#
#--------#-----#
#--#-------###-#
#------#-----#-#
#------#---##--#
#--#---------$-#
#--##--###--#--#
##-----------#-#
##-#-#-#.----#-#
##-----#-------#
################