################
#-#--#-----#---#
#--------------#
#------#-#-#---#
#----#---------#
#-#------###---#
#--#---------#-#
##$#-#-#-#-#---#
##-#-------#-#-#
#---.#--##-#---#
#--------------#
################