################
#------##---####
##-#---------.-#
#--#-#-###-#---#
#----#---------#
##-##----------#
#------#-#---#-#
##----#----#---#
#--#-#---#---#-#
##---#-$---#---#
#----#---------#
################