################
##--####--.----#
#--------------#
#-----#-----#--#
##-------------#
##---#--#-###--#
#--#-----#-----#
#-$#-------#-#-#
#--------------#
#---##--####---#
##-------------#
################