################
##--###----#-#-#
##--$----#-----#
#----##-----#.-#
#------#-------#
#-#--#--------##
#--------------#
##------#-##---#
#----#---------#
#----#-#-------#
#--------------#
################