################
##-#--#-#----#-#
#--#-----#-----#
#--###---#-#-#-#
#------#-----#-#
###--###----#--#
#----#---------#
#----#----###--#
##-----#-------#
##-#-##-#-$-#--#
#-----.--------#
################