################
#---#---##--#--#
##-#-#---------#
#--------#---#-#
##-------#---#-#
#---#----#-##--#
#------#-------#
#-##------##---#
#----------$-#-#
#-----#-#----.-#
#--#-----------#
################