################
##-#-#---###---#
##------.--#---#
##-#---###---#-#
#-$------#---#-#
##-#-----#--#--#
#----------#---#
#--##----#-#-#-#
#--------#-----#
##-#---#---#-#-#
#------#-------#
################