################
#-###-#--#--#-##
#--#-------#---#
#-$------------#
#----#-----#---#
######.----#-#-#
#------#---#---#
##--##-----##--#
#--------#---#-#
#--#-#-#---#---#
#--#-----------#
################