################
#--#####-----###
#-.------------#
#-##---#-#-##$-#
##---#---#-----#
#----##--#####-#
#--------------#
#--###--#--##--#
#----#---------#
##---###------##
#--------------#
################