################
##----#----##-##
##-------------#
##------##-#-#-#
##-------------#
#####----------#
#----#---------#
#----.-#-#-###-#
##$--#---------#
##-##---##-#-#-#
#--------#-----#
################