################
##-------##---##
#--------------#
##-------#---#-#
##-#---------#-#
##-----.---#-#-#
#--------------#
#------#-----#-#
##-----------#-#
#-----##-#---$-#
##-------------#
################