################
##--#-#--#-#--##
##-#--------$--#
##--##-.--####-#
#----#---------#
#-#----#-#-#---#
#------#-------#
##--##------##-#
#----------#---#
#---#--#####---#
#----#---------#
################