################
##--#------#--##
#--------------#
##-----#-#.-#--#
##---#---------#
#--##----#-#--##
#--------------#
##---#----#----#
#-$------#-----#
##------#--##--#
#----------#---#
################