################
#---####------##
#--#---------.-#
#-$##-------#--#
#--------------#
###--##----#---#
#----#---------#
#--------#-----#
##-------#-----#
#--##-##-------#
#----------#---#
################