################
#----#--#-#----#
#--------------#
#-#-.----##----#
##-----#-------#
##-#-#----$--#-#
#----#---------#
#--#---#-###-#-#
##-----#-------#
#--#--##-###-#-#
##-------------#
################