################
#---###----##-##
##-------------#
#--#-.-------###
##-------#-#---#
#-#--#-----##--#
#----#-------#-#
#--#--##-#-$-#-#
#------#-----#-#
#---#------##--#
##-------------#
################