################
#-####-----##--#
#--#---#-------#
##-----##----###
#--------------#
#-#--#---#---#-#
#--#--.--#---#-#
#----#-#-#-#---#
##---#---#-----#
#--#-------$-#-#
#--------------#
################