################
#--#-#-#---#-#-#
##----------$--#
#--#--#--##--#-#
##-------------#
#--#---------#-#
#------#-------#
#---#----------#
##---#--.----#-#
##-#--#------#-#
#--------------#
################