################
#--##--#-------#
#----#---------#
##-#-----###-#-#
#--#-----#-----#
##-----#----####
#--#-----------#
#----##----#---#
#--#-----#-#---#
#------#----##-#
#------#-.---$-#
################