################
#-##---#-----###
#----------#.--#
#-#------------#
##---#---#-#---#
##---#--##-#---#
#----------#-$-#
##-#--#--#-#---#
#--------------#
##-#-#-###-###-#
#----------#---#
################