################
#-###-##---#-#-#
#--#---#-------#
#-$--#---#-##--#
#----#-#-------#
#--------#----##
#--#---#-------#
#-----##-##--#-#
##-------------#
##-#-##--#--#--#
##-----------.-#
################