################
#-##--------##-#
#--------$-----#
#--------------#
##-#.#-------#-#
#--#-#-----##--#
#--------#-----#
##----##-#--#--#
##-------#-----#
##-----------#-#
##---------#---#
################