################
#-#-##-#--##--##
#--------------#
#----#-##----#-#
#----#---------#
#-#----###---#.#
#----------#-#-#
##---#-#--#--#-#
#------#-----#-#
##--##---#-#-$-#
#--------#-----#
################