################
#-#--###-#--##-#
#--------------#
#------------###
#--------------#
#--#---##--#---#
#--#-----------#
##--#--#---##--#
#----#----.--#-#
##-#--#---#--$-#
#--------#-----#
################