################
##-#-#-#--#-####
#---.----------#
#-#-----####---#
#----#---#-----#
##-#-#-###--#--#
#----------#---#
#--#---##-#----#
##---#---#-----#
#---##---#-#-$-#
#------#-------#
################