################
#------#------##
#--------------#
##$##----#---###
##-------#-----#
#-----#---#----#
#--#---------#-#
#---#-#----#-#.#
#------------#-#
##-#-#------#--#
##-#-----------#
################