################
#-###-----#---##
#--$-----------#
#---#---#-.#---#
#--------------#
#-----##-------#
#----#---#-----#
###----#--#-##-#
#--------#-----#
##-##--#-----#-#
#--------------#
################