################
#--###-##-##-###
#--#-------#---#
#-----#--#---#-#
#------------#-#
#----#-#--#----#
#----#--$------#
#--#-----------#
##-----#-----#-#
##-----###-#---#
##-----------.-#
################