################
##-#-##-##-###-#
#--------------#
##------##-----#
##-#--------.--#
#--------------#
#--------#-#---#
##-#--#--------#
##---------#---#
##-#---#--##-$-#
##-------------#
################