################
##-#-#--#-#--#-#
##---#---------#
###---##----##-#
#--#-#-----.---#
##-#-#----#--#-#
#--#-#---------#
#----#-----#-#-#
##-#-------#---#
#--#-$#--------#
##-------------#
################