################
#-#--#-#-#--#--#
#----#-----$---#
##---#-#-------#
##-------------#
##---##-##-###-#
#--------------#
##-#-##-----#-##
#--#.----#---#-#
#----------#---#
#--------------#
################