################
#-#-##-------#-#
#------.-------#
###----#-#-#---#
#--------------#
#--#--#--#-----#
#--------------#
#--------#--$--#
#--------#---#-#
##---#-#--##-#-#
#--------------#
################