################
##-###---#----##
##---#-.-------#
#--#--#--#-----#
#--#-----#---#-#
##--#----#--#--#
#--------#-----#
##---##--#-$--##
##-----------#-#
##-#-###---##--#
##-------#-----#
################