################
###-##-#---#--##
#--------------#
#--#-------#-#-#
#------------#-#
##--#---##---#-#
#--------------#
#-#----#-#.-####
#--------------#
##-#---###---$-#
#--------------#
################