################
#-##--##---#-#-#
#----#---------#
#--#-----#--#--#
##-$-#-----#---#
##---#---##--#-#
#--#-----------#
#--------#---#-#
#----------.---#
##-#-#--##---###
#--------#-----#
################