################
####--#--#-##-##
##-----------$-#
##-#-###-------#
#--#-----#-#-.-#
##-#-#---------#
#----#-------#-#
#---###---###--#
#--------------#
##-#--#----###-#
#----#---------#
################