################
##---#-#-#--#-##
##----------.--#
#--#-#------#--#
#----#---#-----#
##----#--#-----#
#------------#-#
#---#------#---#
##-#-----#-----#
##--$--##--##--#
#--------------#
################