################
#-##----#####-##
#--$-#---------#
#--#-#---#-#---#
##---------#---#
#---##-------#-#
#------#---#---#
#--###-#-----#-#
#--#-----.-----#
#--------------#
#--------------#
################