################
##----.-#-#--###
##-------------#
#-$----#--##---#
##---------#---#
#---##-----#-###
#--#-----#-----#
#---------#--#-#
#--------------#
#----#-----#-#-#
##-------------#
################