################
#--#-##-----#--#
#----#---------#
#-------#----#-#
##-------------#
##--#-#----#-###
#-$--------#---#
##-#-##-##-#-.-#
##-#-#---------#
##-#-#----##---#
#--#---#-------#
################