################
#---###--##-#-##
##---#---------#
#-##-#--.#---#-#
#--------------#
#--#-#-#-#-----#
#--------------#
####---#-------#
#------#-#---$-#
##-#-----#-##--#
##-----#-------#
################