################
##----#-#----#-#
#--------#--.--#
#----#-#-#-----#
#--------------#
#---#--------#-#
#----#---#-----#
##----$#---#---#
#--------------#
#---##-##----#-#
##-----#-----#-#
################