################
###---#--#---###
#----------#---#
#--#----#---#$-#
##-------#-----#
##-----#-----#-#
#----#-#-------#
##-#-------#-#-#
#--------#-----#
#--#-----#-----#
#--#-------.---#
################