################
#--#-#---------#
#----#---------#
#----#-----#-#-#
#--#-----.-----#
##--#-----#----#
#------#-------#
#---###----#-#-#
#----------#-$-#
#--#-#---###-#-#
#------------#-#
################