################
##-#----#------#
#-$------------#
#---##------#--#
#----------#---#
#---#--###-#-#-#
#------#-.-----#
#-------#------#
#--------------#
#--##--#---##--#
##-----#-------#
################