################
##--#-#--#-#---#
#---.----------#
##-#-#-##-#----#
#----------#---#
#--#-#----#----#
#------------#-#
#--#-------#-$-#
##-#---#-----#-#
##-#----##-----#
#----#---------#
################