################
##---##-#---##-#
#--------#---#-#
#--#####-#-.-$-#
##-----#-------#
#-----#-#-##-#-#
#--#-------#---#
#----#-#-#-----#
#--#-#---------#
#--#---#----#--#
##-------------#
################