################
#----#---#----##
##-------------#
##---#---#-#-#-#
#-$-------.----#
##---###------##
#--#-----------#
#------#---##--#
#----------#---#
#-------##-#---#
#--------------#
################