################
##-###--##-##-##
#--------------#
#----#-#--#----#
#------#.------#
##----------#--#
#------#-------#
#------##-#---##
##-------------#
#---#-#-$-#--#-#
#--------------#
################