################
#---##---##----#
#--------------#
#----#---#-----#
#--------#---#-#
#--#-##--##--#.#
#------------#-#
#--###---#-#-$-#
##-----#-----#-#
#--#-#---##-#--#
#----#---------#
################