################
#-#-#-#---##--##
#----.---------#
##-----#-#-#---#
#--#-#---#-----#
#--------#---#-#
#----------#-$-#
#--#-------#-#-#
##-------------#
##-------------#
#--------------#
################