################
#-#--##-###-#--#
#--------------#
##-#----##---#-#
##-------------#
#----#---#-#---#
#----#---#-#.--#
#----##--------#
#--#-----------#
##-#-$-#-------#
##-------------#
################