################
##---##-#------#
#--------------#
#----------#-#-#
#------#---#---#
##-#-----.-#---#
#--------#---#-#
#----#--##-##--#
#------$-------#
##-----#-#----##
#--------------#
################