################
#-#-###--##--###
#--------------#
#-##----.##----#
#------------#-#
#--#-#-##---$--#
#----------#-#-#
#--#--#-----#--#
##-----------#-#
##---#----#--#-#
##-------------#
################