################
#---#-#######-##
##---$---------#
#--#---#-#-##--#
##--.----------#
##--##--##--#--#
#--------------#
#----------###-#
##-------------#
##---#---##--#-#
##---#-------#-#
################