################
##----#----#--##
#--------------#
##---##------#.#
#----------#-$-#
#--#-##------#-#
#--------------#
#---#---###----#
#--#-#---------#
##-----#---#--##
#----#---------#
################