################
#--##-####-#--##
##-#------$----#
#------#---#-#-#
#----#---.-----#
##-###---#-----#
#--------------#
#--#--##-----#-#
##-------#-----#
##-##--------#-#
#----------#---#
################