################
###--###--##---#
##-#-----------#
##---##---$-#--#
##-#-----------#
#--#-#--##---#-#
#----------#---#
#-#---###------#
#----------#---#
##---##-#------#
##---.---------#
################