################
##--#-----###--#
#--------#-----#
##-.-----###-#-#
#--#---------#-#
#---##------#--#
#--------------#
##-#-----##----#
##-#---------#-#
##---#-#-#$#---#
#----------#---#
################