################
###----#-#----##
##-------------#
####-#---------#
#------#-------#
#-##-#--##---#-#
#--------#-#---#
#-----#-----#$-#
#-----.--------#
#------------###
##---#---------#
################