################
##-#--##--#--#-#
#--#.----------#
#--#---#-#---#-#
##-------------#
##-#-##------###
#----------#-$-#
#-----#------#-#
#------------#-#
##-------------#
#--------------#
################