################
#-#----####-##-#
#-------.----#-#
#--###--###----#
#--------------#
###----#----#--#
#----#---------#
#--#--#---#----#
##---------#-#-#
##---------#$#-#
#--------------#
################