################
#-##---######--#
#--------------#
#-##-----#---#-#
#------.---#---#
##-#-##--#--#--#
#--------#-----#
#--##--------#-#
##-------#-----#
##-#$#--#-##---#
#------------#-#
################