################
####-##----#--##
#--#-----------#
#--#-$---------#
##-----#-.-#---#
###---#----#---#
#--#---------#-#
##-##----------#
#----#---------#
#----#-##--#-#-#
##-------#-----#
################