################
#--#--###--#--##
##-----#-------#
#--------------#
#------.-------#
#--#-#---#-----#
#--------------#
#------#-#--#--#
#------------$-#
####-#---#-#---#
##-------------#
################