################
#----##-#---##-#
#--------------#
##---------#-#-#
#----.---------#
#--#-###--#--#-#
#--------------#
#---##---#-----#
#--------------#
##--#-##---$-#-#
#--------#-----#
################