################
###--#-#---#-###
#----#------$--#
#-##-##--#-----#
#--------------#
#--#-.--##---#-#
#----------#---#
#--#-#-#####---#
#------#-----#-#
##--##----###--#
#--------------#
################