################
##----##--#-##-#
#----------$---#
####---------#-#
#--#---#-------#
#----###-------#
#--------------#
#--#---#-##-##-#
#--------#---#-#
#--#-#-------#-#
##--------.----#
################