################
#---#---------##
#--------------#
##---#---#-----#
##---#-------#-#
#----#---------#
#--------------#
##----##-#-#-#-#
#--#--.--------#
#-----#$##--##-#
#--------------#
################