################
#----#-#--#--#-#
#--#-#---------#
#--#-$-##---#-##
#--------------#
##---##-#-#----#
#----------#---#
#------#-------#
#----#-----#---#
##--------.--#-#
#--------------#
################