################
###---######---#
##-------------#
##-#-----#-----#
##---------#---#
#--------------#
#------#-------#
#--##------#---#
##---.-#-------#
#--#------$--#-#
#--------#-----#
################