################
#-###-#----###-#
#--------#-----#
##-#-#----##-$-#
##---#---------#
####-----#-#-#-#
#------#------.#
##-----##------#
##-#---#-------#
##-#-----#---#-#
#--------------#
################