################
#----##--#--##-#
#----------#---#
#-#--##-#------#
#--------#-----#
##$#-#---#---#-#
#--#-----------#
#-----#-###.--##
##---#---------#
####---#----#--#
#--------------#
################