################
###-#-##--#--###
##------.------#
##-#-#-#-------#
##-------------#
##-#--#--##-#--#
#------#-------#
#------#-#-$-#-#
#----------#-#-#
####-##-#--#-#-#
#--------------#
################