################
#---####---###-#
#------#----.--#
##-#---#-#-#-#-#
##-#-#-----#-#-#
#----#---#-#---#
#---$#---#---#-#
#-------#-#----#
#------------#-#
##----###------#
#--------------#
################