################
####-#-------#-#
##-----------#-#
##-----#-------#
#----#-----#---#
##------#------#
#------#---#---#
#---#.#--#-#---#
#-----------$--#
#--------##----#
#--------------#
################