################
##-#-###--#-##-#
#--------------#
##----##----##-#
##-#---------#-#
##---#-#-#-----#
#----------#-$-#
#-##-#-##--#-#-#
##---#-----#-#-#
#--#--#--------#
##---------.---#
################