################
##-##--------#-#
##-#-#---------#
#--#------##---#
#------------.-#
##--------#----#
#--------#-----#
###------#---#-#
#---------$--#-#
#-----##---#---#
##-------------#
################