################
######-#-####--#
##------$------#
##-#------#--#-#
#------#-------#
##-#--#----#-#-#
#--#----------.#
##-----#-#-----#
#--------------#
#--#-----#-#---#
#--------------#
################