################
##-----#--######
#--------------#
#-#------###-#-#
#----#---------#
##-#--##--##-#-#
#-$------------#
##---------#-#-#
##-#---#---#---#
##-#-#-#-#-----#
##----------.--#
################