################
#---##-#--##--##
#------#-------#
#--#-----#---###
#--------#-----#
##-#-----#-----#
#--------------#
##---------#---#
#------------#-#
###----#-#-$-#-#
#-----.--------#
################