################
####----##-#--##
#--------------#
##-------##--#-#
#----#---------#
#----#-----##--#
#--#-----#-#-#-#
##---##-##--$--#
##-#----.------#
#-------##-#-###
#--------------#
################