################
###-------#-##-#
##-------------#
###----#-#--#--#
##-----.-------#
##---#-#---#---#
#------#---#---#
#--------#----##
#--------#--$--#
#----------#-#-#
#----#-----#---#
################