################
##--#-#--###--##
#----------#---#
###-#----#-#-$-#
##---------#---#
##-#-###-------#
#----------.---#
##-------#---#-#
#--------------#
#-----#--###---#
#--------------#
################