################
#--#--#-----#--#
##-------#--$--#
######---------#
#--------------#
##---#---------#
#--#-----------#
##----##---#-#-#
##-------------#
#--##--.-------#
##-------------#
################