################
####-#---#####-#
#--------------#
#----#---###---#
##-------#-----#
#--#-----------#
#----#---#-----#
#--#--#-#-----##
##-------#-----#
#---##-#$-#--#-#
#----#-------.-#
################