################
##------------##
#--------------#
#---##-###--#$-#
#--------------#
##-#-#-#----#-##
#--#-----#-----#
##----#----#---#
#----------#---#
#----#-#-------#
#-.------------#
################