################
#----#-##----###
#--------#-----#
#-##-#-----#---#
#------#-------#
##-##---##-----#
#--#-----------#
#-##-#-#-----#-#
#--------#-#---#
#--#-#--##-$-#-#
##-----.-------#
################