################
#-------#---#-##
#--------------#
#------#-#--#--#
#--#---#---#---#
##---##--#-#---#
#--#---------#-#
#--#-##--#-#-$-#
#----.---------#
##-###-#----##-#
##-------------#
################