################
#-###---#-#----#
#----------#---#
#-$#---##--#---#
##---#---#---#-#
#----#-#---###-#
#----#---------#
#-----#---#----#
##-----------#-#
#----------#---#
#-----------.--#
################