################
##---####-#---##
##--$----------#
##---##-#-.#---#
#--------------#
##-###---#-##--#
#--------------#
#-----#------###
##-#-#-----#---#
#--#-------#---#
#------------#-#
################