################
##-----#--#-#-##
##-#-----------#
#--#-#-----##--#
#--#-----------#
##-#----###-##-#
#-------------.#
#--#-##--#$##--#
#----#---------#
##-------###---#
#--------------#
################