################
##--##---##----#
#----------#---#
#-$--#---#-----#
##-----------#-#
##-#-#------##-#
#--#------.----#
##--#----#-----#
#--------------#
#--#---#-#---#-#
#--------------#
################