################
##--##-.----#--#
#----#---------#
####-#--#------#
##---------#---#
#---#-#-##-$-#-#
#--------------#
##--#--#--####-#
##-------#-----#
#----###-----#-#
##-#-----------#
################