################
##-#------#--#-#
#---.----------#
#--#-----#--#$-#
#--------#-----#
#----####--#-#-#
#------#-----#-#
##---------##--#
#------#-----#-#
##----######---#
#--------------#
################