################
#------#------##
#-----.--------#
#-##-------#---#
##-------------#
#----#---##----#
#--#-#---------#
##-#----#----#-#
#--#-#---------#
##---#--$##--#-#
#--------------#
################