################
#--##--##------#
#----#---------#
#-##-----###-#-#
##---------#---#
#---#--#---###-#
#-$------------#
#----##---#----#
##-#-----------#
#----#-#--#--.-#
#----------#---#
################