################
##--#-###------#
#--------------#
##-----#-#-----#
#--------------#
#--#-#-----#-###
#---$----------#
#-##---#-##----#
##---#---#-----#
#--------#---.-#
##-------------#
################