################
#-----------#--#
#--#--$--------#
#--##----#-#-#-#
#--#---#-------#
#----##-------##
#--------------#
##-----##------#
#--------------#
##-#-#---#-.##-#
##---#---------#
################