################
#-#---###--#-#-#
#--#-----------#
##---#--####---#
#--------------#
##----#----#---#
#------#---#-#-#
##--#----##--#-#
#--------------#
#--#---#.#-#-$-#
#--------------#
################