################
#-#---#----#-#-#
#--------------#
##----##----##-#
##-------#-----#
#--------------#
#----#-#-------#
#-###--#-#-#---#
##-----#-------#
#-$-----.#--#--#
#--------------#
################