################
###--#-#####---#
##--$--#-------#
##---#-#-#-#-#-#
#--#-#----.#---#
##-#-----------#
#--------------#
#--#---#-#---#-#
##-------#-----#
#--#--------####
#--------------#
################