################
#-----#--------#
#--.-----------#
#----#---##-#--#
#--------#-$-#-#
#----#-#-----#-#
#----------#-#-#
###--#-##----#-#
##---------#---#
#-------#--#---#
#--------#-----#
################