################
#-##---###-#---#
#--------------#
##-$##-----#-#-#
#--------#---#-#
#--###-------#-#
#------#---#---#
#--#-----#-#---#
#------------.-#
#---#----------#
#--------------#
################