################
####--------#-##
#----#---------#
##----#--###-#-#
##-#-#-----#-$-#
#--#-#--##---#-#
#----#-----.---#
##-#---#---##--#
#------#-#-----#
#----###-#-#---#
#--------------#
################