################
#---##-#-#--#--#
##-#-----$-----#
#----####--#---#
#--------------#
#----#--#--#---#
#------------#-#
#--##-#-#------#
#---.----#-----#
#--------------#
#--------------#
################