################
##------##---###
##-------------#
###------#-#$#-#
##-----#-----#-#
#---###-----##-#
#----#-----#---#
#-##-#--#------#
#------#---#---#
#--#---#-#---#-#
#--------.-----#
################