################
#--###--##-##-##
#--------------#
#----#----###--#
#--------------#
#----#-----#-#-#
#----#---------#
#-------.--#-#-#
#----#-------#-#
##--#--#-#-#-$-#
#--------------#
################