################
#####-#---##--##
#------------#-#
#--#-#-#--.----#
#------#-#-----#
#-#-#-#--#---#-#
#--------#-#---#
#------#-------#
#--#-------#---#
#-$--#####-#-###
#--------------#
################