################
#--#-#------#-##
#--#---------$-#
#----#-#--##---#
#------#-------#
#-#----#-##--#-#
#--------------#
#-------#-#-##-#
#------#-------#
##---#-#-------#
##---.---------#
################