################
###-#----------#
##-------------#
#---#-----##-#-#
#-$----#---.---#
##---#---#-#-#-#
#--------------#
#--##-----##---#
#--------------#
#----#-#----#--#
#----------#---#
################