################
#----#-#-#---###
##-------------#
##------##---#-#
#--------#-----#
#----#-------#-#
#----------#-$-#
#---#-##-#-#-#-#
##-----------#-#
#------#--.----#
##-------------#
################