################
#-#--##--#--##-#
#------$-------#
#-#----#-##----#
#----------#---#
##-----##-----##
#--#-------#-#-#
##---##-#--#---#
#--------------#
#---#-##--##-#.#
##-------------#
################